"au" = (/obj/structure/flora/junglebush/large,/turf/open/water/jungle,/area/space)
"cO" = (/obj/effect/decal/cleanable/dirt,/turf/open/floor/plating/dirt/jungle,/area/space)
"ez" = (/obj/item/food/grown/tomato/blood,/turf/open/floor/grass,/area/space)
"fj" = (/obj/structure/fence,/obj/effect/decal/cleanable/blood/gibs/up,/turf/open/floor/grass,/area/space)
"hJ" = (/obj/effect/decal/cleanable/blood/old,/turf/open/floor/grass,/area/space)
"iB" = (/obj/structure/fence{dir = 4},/turf/open/floor/grass,/area/space)
"iJ" = (/obj/structure/flora/junglebush/c,/turf/open/water/jungle,/area/space)
"lk" = (/obj/structure/flora/ausbushes,/turf/open/floor/plating/dirt/jungle,/area/space)
"mh" = (/obj/structure/flora/grass/jungle,/turf/open/floor/grass,/area/space)
"ms" = (/obj/structure/flora/rock/pile/largejungle,/turf/open/water/jungle,/area/space)
"mt" = (/turf/open/floor/plating/dirt/jungle,/area/space)
"my" = (/obj/structure/flora/rock/jungle,/turf/open/floor/plating/dirt/jungle,/area/space)
"nr" = (/obj/structure/fence,/obj/effect/decal/cleanable/blood/gibs/down,/turf/open/floor/grass,/area/space)
"oI" = (/obj/structure/fence/corner{dir = 5},/turf/open/floor/plating/dirt/jungle,/area/space)
"pl" = (/obj/structure/flora/ausbushes/lavendergrass,/turf/open/floor/plating/dirt/jungle,/area/space)
"pN" = (/obj/effect/decal/cleanable/leaper_sludge,/turf/open/floor/plating/dirt/jungle,/area/space)
"rN" = (/obj/structure/flora/junglebush/large,/turf/open/floor/plating/dirt/jungle,/area/space)
"rZ" = (/obj/item/organ/eyes/night_vision/mushroom,/turf/open/water/jungle,/area/space)
"tz" = (/obj/structure/fence/door/opened,/turf/open/floor/grass,/area/space)
"uX" = (/obj/structure/flora/ausbushes/palebush,/obj/effect/decal/cleanable/blood/gibs/limb,/obj/effect/decal/cleanable/dirt,/turf/open/floor/grass,/area/space)
"uY" = (/obj/structure/flora/ausbushes/genericbush,/obj/effect/decal/cleanable/dirt,/turf/open/floor/grass,/area/space)
"vy" = (/obj/structure/flora/ausbushes/pointybush,/turf/open/floor/grass,/area/space)
"vB" = (/obj/structure/flora/rock/pile/largejungle,/turf/open/floor/plating/dirt/jungle/dark,/area/space)
"vY" = (/obj/structure/fence,/obj/effect/decal/cleanable/dirt,/turf/open/floor/grass,/area/space)
"wa" = (/obj/effect/decal/cleanable/dirt,/turf/open/floor/grass,/area/space)
"wW" = (/obj/structure/flora/rock/jungle,/turf/open/water/jungle,/area/space)
"xV" = (/obj/structure/flora/ausbushes/ywflowers,/obj/effect/decal/cleanable/blood/old,/turf/open/floor/grass,/area/space)
"yj" = (/obj/structure/fence/corner,/turf/open/floor/grass,/area/space)
"zG" = (/obj/structure/flora/tree/jungle,/turf/open/floor/plating/dirt/jungle,/area/space)
"BS" = (/obj/structure/flora/ausbushes/fullgrass,/turf/open/water/jungle,/area/space)
"Cy" = (/obj/structure/flora/ausbushes/leafybush,/turf/open/floor/plating/dirt/jungle,/area/space)
"Ij" = (/obj/item/organ/ears/penguin,/turf/open/water/jungle,/area/space)
"Io" = (/obj/item/seeds/cocoapod/bungotree,/turf/open/floor/grass,/area/space)
"ID" = (/obj/structure/fence{dir = 8},/turf/open/floor/plating/dirt/jungle/dark,/area/space)
"JL" = (/turf/open/water/jungle,/area/space)
"Lt" = (/mob/living/simple_animal/hostile/jungle/seedling,/obj/item/ship_in_a_bottle,/turf/open/water/jungle,/area/space)
"OK" = (/obj/effect/decal/cleanable/insectguts,/obj/effect/decal/cleanable/dirt,/turf/open/floor/grass,/area/space)
"Pg" = (/obj/structure/flora/ausbushes/reedbush,/obj/item/organ/heart/cursed,/turf/open/water/jungle,/area/space)
"Py" = (/obj/structure/flora/rock/pile,/obj/effect/decal/cleanable/blood/old,/turf/open/floor/grass,/area/space)
"Qe" = (/obj/effect/mob_spawn/human/corpse/cargo_tech,/turf/open/water/jungle,/area/space)
"QF" = (/obj/effect/decal/cleanable/blood/gibs/torso,/turf/open/floor/grass,/area/space)
"QV" = (/obj/item/organ/liver/plasmaman,/turf/open/water/jungle,/area/space)
"Rg" = (/obj/effect/decal/cleanable/blood/gibs/body,/turf/open/floor/grass,/area/space)
"RO" = (/turf/open/floor/grass,/area/space)
"SA" = (/obj/structure/fence,/turf/open/floor/grass,/area/space)
"SH" = (/obj/structure/fence{dir = 8},/turf/open/floor/grass,/area/space)
"SI" = (/obj/structure/flora/tree/jungle/small,/turf/open/floor/grass,/area/space)
"ST" = (/obj/effect/decal/cleanable/insectguts,/turf/open/floor/grass,/area/space)
"TD" = (/obj/structure/fence/corner{dir = 1},/turf/open/floor/plating/dirt/jungle,/area/space)
"Uv" = (/obj/structure/flora/ausbushes/reedbush,/turf/open/water/jungle,/area/space)
"Vf" = (/obj/structure/flora/ausbushes/reedbush,/obj/item/organ/tongue/lizard,/turf/open/water/jungle,/area/space)
"Vu" = (/obj/structure/flora/ausbushes/brflowers,/turf/open/floor/grass,/area/space)
"VB" = (/obj/structure/flora/ausbushes/ppflowers,/obj/effect/decal/cleanable/dirt,/turf/open/floor/grass,/area/space)
"WR" = (/obj/structure/fence/corner{dir = 8},/obj/effect/decal/cleanable/dirt,/turf/open/floor/plating/dirt/jungle,/area/space)
"ZE" = (/turf/template_noop,/area/template_noop)

(1,1,1) = {"
ZEZEZEplmtpNcOmtZEZEZE
ZEZEmtmtSIuYVuwamtlkZE
ZElkWRIDSHSHSHSHSHoImt
ZEcOSAmhhJUvauQFROSAmt
mtrNvYezVfBSJLrZSISAST
plROnrIjJLQeLtJLmsSAVB
mtOKSAPywWJLJLJLQVvYIo
mtvBSAuXSTPgJLiJxVfjlk
mtzGTDiBiBSHtziBiByjCy
ZEZEmtlkwaRgROROvymtcO
ZEZEZEZEmtmycOpNplmtZE
"}
