"aa" = (/obj/item/extinguisher/mini,/turf/open/floor/grass,/area/ruin/unpowered)
"bz" = (/obj/item/grown/bananapeel,/obj/effect/decal/cleanable/dirt,/turf/open/floor/plating/dirt,/area/ruin/unpowered)
"bO" = (/obj/effect/turf_decal/siding/wood{dir = 1},/obj/effect/decal/cleanable/dirt,/obj/effect/decal/cleanable/garbage,/turf/open/floor/plating/dirt/jungle,/area/ruin/unpowered)
"bS" = (/obj/structure/closet/crate/miningcar,/obj/effect/decal/cleanable/blood/old,/turf/open/floor/grass,/area/ruin/unpowered)
"co" = (/obj/structure/table/wood,/obj/item/food/grown/banana,/obj/effect/decal/cleanable/cobweb,/turf/open/floor/wood,/area/ruin/unpowered)
"do" = (/obj/effect/turf_decal/siding/wood,/obj/structure/barricade/wooden,/obj/effect/decal/cleanable/dirt,/obj/effect/decal/cleanable/dirt,/turf/open/floor/plating/dirt/jungle,/area/ruin/unpowered)
"ds" = (/mob/living/carbon/human/species/monkey,/obj/effect/decal/cleanable/dirt,/obj/effect/decal/cleanable/oil/slippery,/turf/open/floor/grass,/area/ruin/unpowered)
"ey" = (/obj/effect/turf_decal/siding/wood{dir = 4},/obj/effect/decal/cleanable/food/egg_smudge,/turf/open/floor/grass,/area/ruin/unpowered)
"eG" = (/obj/effect/decal/cleanable/insectguts,/turf/open/floor/plating/dirt/jungle,/area/ruin/unpowered)
"gu" = (/obj/effect/decal/cleanable/dirt,/obj/effect/spawner/lootdrop/food_packaging,/turf/open/floor/plating/dirt/jungle,/area/ruin/unpowered)
"gU" = (/obj/structure/flora/tree/jungle/small,/turf/open/floor/plating/dirt,/area/ruin/unpowered)
"he" = (/obj/effect/decal/cleanable/ash,/turf/open/floor/grass,/area/ruin/unpowered)
"hI" = (/obj/effect/decal/cleanable/dirt,/turf/closed/wall/mineral/wood,/area/ruin/unpowered)
"iL" = (/turf/template_noop,/area/template_noop)
"jB" = (/obj/effect/turf_decal/siding/wood{dir = 8},/obj/effect/spawner/lootdrop/food_packaging,/turf/open/floor/grass,/area/ruin/unpowered)
"kp" = (/obj/item/grown/bananapeel,/turf/open/floor/grass,/area/ruin/unpowered)
"ky" = (/obj/effect/turf_decal/siding/wood{dir = 8},/turf/open/floor/grass,/area/ruin/unpowered)
"ll" = (/obj/structure/table/wood,/obj/item/storage/box/ingredients/exotic,/obj/effect/decal/cleanable/food/salt,/turf/open/floor/wood,/area/ruin/unpowered)
"lr" = (/obj/effect/decal/cleanable/dirt,/obj/effect/decal/cleanable/ash,/turf/open/floor/wood,/area/ruin/unpowered)
"mj" = (/obj/structure/table/wood,/obj/item/hatchet/wooden,/turf/open/floor/grass,/area/ruin/unpowered)
"mB" = (/turf/open/floor/wood,/area/ruin/unpowered)
"nj" = (/obj/effect/decal/remains/human,/turf/open/water/jungle,/area/ruin/unpowered)
"oO" = (/turf/open/water/jungle,/area/ruin/unpowered)
"pb" = (/obj/structure/barricade/wooden/crude,/obj/structure/barricade/wooden,/turf/open/floor/plating/dirt,/area/ruin/unpowered)
"qh" = (/obj/structure/table/wood,/obj/item/food/bread/banana,/obj/effect/decal/cleanable/cobweb/cobweb2,/turf/open/floor/plating/grass/jungle,/area/ruin/unpowered)
"qv" = (/obj/effect/decal/cleanable/dirt,/obj/effect/decal/cleanable/dirt,/obj/effect/decal/cleanable/insectguts,/turf/open/floor/plating/dirt,/area/ruin/unpowered)
"qY" = (/obj/effect/decal/cleanable/ash,/turf/open/floor/wood,/area/ruin/unpowered)
"rX" = (/obj/structure/bonfire/prelit,/turf/open/floor/wood,/area/ruin/unpowered)
"sa" = (/obj/effect/decal/cleanable/dirt,/turf/open/floor/plating/dirt/jungle,/area/ruin/unpowered)
"sz" = (/turf/open/floor/grass,/area/ruin/unpowered)
"sM" = (/obj/effect/decal/cleanable/food/plant_smudge,/turf/open/floor/grass,/area/ruin/unpowered)
"sR" = (/obj/effect/turf_decal/siding/wood{dir = 4},/obj/effect/decal/cleanable/dirt,/turf/open/floor/grass,/area/ruin/unpowered)
"ty" = (/obj/item/grown/bananapeel,/obj/effect/decal/cleanable/dirt,/turf/open/floor/grass,/area/ruin/unpowered)
"tL" = (/obj/effect/decal/cleanable/oil/slippery,/turf/open/floor/grass,/area/ruin/unpowered)
"vk" = (/obj/effect/decal/cleanable/oil/slippery,/turf/open/floor/plating/dirt,/area/ruin/unpowered)
"vv" = (/turf/closed/indestructible/wood,/area/ruin/unpowered)
"wc" = (/obj/structure/table/wood,/obj/item/food/grown/banana,/turf/open/floor/grass,/area/ruin/unpowered)
"wV" = (/obj/item/food/monkeycube/gorilla,/turf/open/floor/grass,/area/ruin/unpowered)
"ya" = (/obj/structure/closet/secure_closet/freezer/cream_pie,/obj/effect/decal/cleanable/food/tomato_smudge,/turf/open/floor/wood,/area/ruin/unpowered)
"ye" = (/obj/effect/decal/cleanable/dirt,/turf/open/floor/wood,/area/ruin/unpowered)
"yi" = (/obj/structure/barricade/wooden,/obj/effect/turf_decal/siding/wood,/turf/open/floor/grass,/area/ruin/unpowered)
"yq" = (/obj/effect/turf_decal/siding/wood{dir = 1},/obj/effect/spawner/lootdrop/food_packaging,/turf/open/floor/grass,/area/ruin/unpowered)
"yR" = (/obj/effect/decal/cleanable/glass,/turf/open/floor/grass,/area/ruin/unpowered)
"yU" = (/obj/effect/decal/cleanable/dirt,/obj/effect/decal/cleanable/dirt,/obj/effect/spawner/lootdrop/food_packaging,/turf/open/floor/grass,/area/ruin/unpowered)
"zo" = (/obj/effect/spawner/lootdrop/food_packaging,/turf/open/floor/plating/dirt,/area/ruin/unpowered)
"zG" = (/obj/structure/barricade/wooden,/obj/structure/barricade/wooden/crude,/turf/open/floor/plating/dirt,/area/ruin/unpowered)
"AQ" = (/obj/structure/table/wood,/obj/item/storage/box/donkpockets/donkpockethonk,/turf/open/floor/grass,/area/ruin/unpowered)
"AY" = (/turf/closed/wall/mineral/wood,/area/ruin/unpowered)
"Bj" = (/obj/structure/flora/tree/jungle/small,/turf/open/floor/grass,/area/ruin/unpowered)
"BJ" = (/obj/structure/closet/crate/wooden/toy,/turf/open/floor/grass,/area/ruin/unpowered)
"BM" = (/mob/living/carbon/human/species/monkey,/obj/effect/decal/cleanable/dirt,/turf/open/floor/grass,/area/ruin/unpowered)
"BQ" = (/obj/effect/decal/cleanable/food/flour,/turf/open/floor/wood,/area/ruin/unpowered)
"Ch" = (/obj/effect/decal/cleanable/garbage,/turf/open/floor/plating/dirt,/area/ruin/unpowered)
"CG" = (/obj/structure/table/wood,/obj/item/pickaxe/improvised,/turf/open/floor/grass,/area/ruin/unpowered)
"DR" = (/obj/structure/barricade/wooden,/obj/effect/turf_decal/siding/wood{dir = 1},/turf/open/floor/grass,/area/ruin/unpowered)
"HG" = (/mob/living/carbon/human/species/monkey,/turf/open/floor/wood,/area/ruin/unpowered)
"Iq" = (/obj/structure/barricade/wooden/crude,/obj/structure/barricade/wooden,/turf/open/floor/plating/grass/jungle,/area/ruin/unpowered)
"Jq" = (/obj/effect/decal/cleanable/dirt,/turf/closed/mineral/random/jungle,/area/ruin/unpowered)
"JD" = (/obj/structure/fermenting_barrel,/turf/open/water/jungle,/area/ruin/unpowered)
"Kl" = (/obj/structure/closet/crate/miningcar,/turf/open/floor/plating/dirt/jungle,/area/ruin/unpowered)
"Lc" = (/obj/effect/turf_decal/siding/wood{dir = 4},/obj/structure/barricade/wooden,/turf/open/floor/plating/dirt/jungle,/area/ruin/unpowered)
"Lu" = (/mob/living/carbon/human/species/monkey,/obj/effect/decal/cleanable/food/pie_smudge,/turf/open/floor/wood,/area/ruin/unpowered)
"NB" = (/obj/structure/flora/tree/jungle,/turf/open/floor/grass,/area/ruin/unpowered)
"NM" = (/obj/structure/water_source/puddle,/turf/open/floor/grass,/area/ruin/unpowered)
"Ph" = (/obj/structure/closet/crate/trashcart/filled,/turf/open/floor/plating/dirt/jungle,/area/ruin/unpowered)
"Ps" = (/obj/effect/turf_decal/siding/wood{dir = 4},/obj/structure/barricade/wooden,/obj/effect/decal/cleanable/dirt,/turf/open/floor/plating/dirt/jungle,/area/ruin/unpowered)
"Rm" = (/obj/structure/barricade/wooden/crude,/obj/structure/barricade/wooden,/obj/effect/decal/cleanable/dirt,/turf/open/floor/plating/dirt,/area/ruin/unpowered)
"RO" = (/obj/effect/turf_decal/siding/wood,/obj/structure/barricade/wooden,/turf/open/floor/plating/dirt/jungle,/area/ruin/unpowered)
"Si" = (/obj/effect/decal/cleanable/dirt,/turf/open/floor/grass,/area/ruin/unpowered)
"SR" = (/obj/item/bedsheet/clown,/obj/structure/bed,/turf/open/floor/wood,/area/ruin/unpowered)
"Vl" = (/obj/effect/decal/cleanable/insectguts,/turf/open/floor/grass,/area/ruin/unpowered)
"Wd" = (/obj/effect/spawner/lootdrop/food_packaging,/turf/open/floor/grass,/area/ruin/unpowered)
"Xe" = (/turf/closed/mineral/random/jungle,/area/ruin/unpowered)
"XE" = (/turf/open/floor/plating/dirt/jungle,/area/ruin/unpowered)
"Yi" = (/obj/effect/decal/cleanable/dirt,/obj/effect/decal/cleanable/garbage,/turf/open/floor/grass,/area/ruin/unpowered)
"ZM" = (/obj/structure/table/wood,/obj/item/flashlight/lamp/bananalamp,/obj/effect/decal/cleanable/cobweb/cobweb2,/turf/open/floor/wood,/area/ruin/unpowered)

(1,1,1) = {"
iLiLiLXeXeXeXeXeXeXeXepbRmXeiL
iLXeXeXeXeXeXeXeXeBJbzqvvkXeiL
XeXevvdoROvvszNMdsSiyUBjChXeiL
XeXePscoLukykpszszwcyiyiXeXeiL
XeXeLcSRmBkyNBVlszAYllZMXeXeiL
XeXeLcqYyejBszszszeyHGBQXeXeXe
XeXevvbOyqvvtyszszsRlrmBXeXeXe
XeXeKlsasMszszwVszhIrXyaXeXeXe
XeXeXeXEXEszSiaaszqhDRDRXeXeXe
iLXeXenjeGXEszSiszszWdYiAQXeXe
iLXeXeJDoOXEszszszszsMszszmjXe
iLXeXeXeoOXEszWdszszSiBMtyVlXe
iLXeXeXePhsaBjkpszCGbSyRSizozG
iLiLXeXeXegutLheNMXeXeJqgUvkzG
iLiLiLXeXepbIqIqXeXeiLXeXeXeXe
"}
