//MAP CONVERTED BY dmm2tgm.py THIS HEADER COMMENT PREVENTS RECONVERSION, DO NOT REMOVE
"ay" = (
/obj/structure/statue/sandstone/venus{
	dir = 1
	},
/turf/open/floor/wood,
/area/ruin/powered)
"aR" = (
/obj/effect/decal/cleanable/oil,
/turf/open/floor/wood,
/area/ruin/powered)
"ch" = (
/obj/structure/railing/corner{
	dir = 8
	},
/turf/open/floor/wood,
/area/ruin/powered)
"cM" = (
/obj/effect/decal/cleanable/dirt,
/turf/open/floor/pod/dark,
/area/ruin/powered)
"ej" = (
/obj/structure/railing,
/obj/effect/decal/cleanable/dirt,
/turf/open/floor/wood,
/area/ruin/powered)
"eK" = (
/obj/item/bedsheet/syndie,
/obj/structure/bed,
/turf/open/floor/wood,
/area/ruin/powered)
"gz" = (
/obj/structure/stairs/east,
/turf/open/floor/wood,
/area/ruin/powered)
"gE" = (
/obj/structure/closet/crate/wooden/toy,
/turf/open/floor/wood,
/area/ruin/powered)
"gW" = (
/obj/structure/railing,
/obj/machinery/power/emitter/energycannon,
/obj/effect/decal/cleanable/ash,
/turf/open/floor/wood,
/area/ruin/powered)
"iw" = (
/obj/item/ammo_box/c45,
/obj/structure/table/wood/poker,
/turf/open/floor/wood,
/area/ruin/powered)
"iC" = (
/obj/item/ammo_box/c9mm,
/obj/structure/table/wood/poker,
/turf/open/floor/wood,
/area/ruin/powered)
"iY" = (
/obj/structure/railing{
	dir = 4
	},
/turf/open/floor/wood,
/area/ruin/powered)
"jc" = (
/obj/structure/railing{
	dir = 1
	},
/obj/structure/railing{
	dir = 8
	},
/turf/open/floor/wood,
/area/ruin/powered)
"jN" = (
/obj/effect/turf_decal/siding/wood/corner{
	dir = 1
	},
/turf/open/floor/plating/dirt/jungle/dark,
/area/ruin/powered)
"kh" = (
/turf/closed/wall/mineral/wood,
/area/ruin/powered)
"lN" = (
/obj/effect/decal/cleanable/dirt,
/obj/structure/stairs/east,
/turf/open/floor/wood,
/area/ruin/powered)
"nD" = (
/obj/item/ammo_box/a40mm,
/obj/structure/table/wood/poker,
/turf/open/floor/wood,
/area/ruin/powered)
"of" = (
/turf/open/floor/pod/dark,
/area/ruin/powered)
"oj" = (
/obj/effect/decal/cleanable/food/egg_smudge,
/turf/open/floor/wood,
/area/ruin/powered)
"oX" = (
/obj/structure/curtain/bounty,
/turf/open/floor/wood,
/area/ruin/powered)
"pd" = (
/obj/item/storage/bag/money/vault,
/obj/item/storage/bag/money/vault,
/obj/item/storage/bag/money/vault,
/obj/item/storage/bag/money/vault,
/obj/item/storage/bag/money/vault,
/obj/structure/rack,
/obj/effect/decal/cleanable/dirt,
/turf/open/floor/wood,
/area/ruin/powered)
"pR" = (
/obj/structure/railing{
	dir = 4
	},
/mob/living/simple_animal/hostile/pirate/ranged,
/turf/open/floor/wood,
/area/ruin/powered)
"qL" = (
/obj/structure/table/wood/poker,
/obj/item/gun/energy/laser/hellgun,
/turf/open/floor/carpet/red,
/area/ruin/powered)
"rc" = (
/obj/effect/decal/cleanable/dirt,
/turf/open/floor/wood,
/area/ruin/powered)
"sH" = (
/turf/open/floor/wood,
/area/ruin/powered)
"tw" = (
/obj/effect/turf_decal/siding/wood{
	dir = 1
	},
/turf/open/floor/plating/dirt/jungle/dark,
/area/ruin/powered)
"tG" = (
/turf/open/water/jungle,
/area/ruin/powered)
"uf" = (
/obj/structure/closet/crate/goldcrate,
/turf/open/floor/wood,
/area/ruin/powered)
"xd" = (
/turf/open/floor/plating/dirt/jungle,
/area/ruin/powered)
"xT" = (
/obj/structure/bonfire/prelit,
/turf/open/floor/wood,
/area/ruin/powered)
"ze" = (
/obj/structure/railing/corner{
	dir = 1
	},
/obj/effect/decal/cleanable/dirt,
/turf/open/floor/wood,
/area/ruin/powered)
"zk" = (
/obj/structure/railing{
	dir = 1
	},
/obj/structure/railing{
	dir = 5
	},
/turf/open/floor/wood,
/area/ruin/powered)
"zN" = (
/obj/effect/turf_decal/siding/wood/corner{
	dir = 4
	},
/turf/open/floor/plating/dirt/jungle/dark,
/area/ruin/powered)
"BV" = (
/obj/structure/bonfire/prelit,
/turf/open/floor/plating/dirt/jungle,
/area/ruin/powered)
"CG" = (
/obj/structure/curtain/bounty,
/obj/effect/decal/cleanable/dirt,
/turf/open/floor/wood,
/area/ruin/powered)
"Dm" = (
/obj/structure/shuttle/engine/propulsion/burst{
	dir = 4
	},
/turf/open/water/jungle,
/area/ruin/powered)
"DC" = (
/obj/structure/railing,
/obj/structure/railing{
	dir = 4
	},
/turf/open/floor/wood,
/area/ruin/powered)
"DH" = (
/mob/living/simple_animal/hostile/pirate/ranged/space,
/turf/open/floor/carpet/red,
/area/ruin/powered)
"DS" = (
/mob/living/simple_animal/hostile/pirate/ranged,
/turf/open/floor/wood,
/area/ruin/powered)
"DV" = (
/obj/vehicle/ridden/lavaboat,
/turf/open/water/jungle,
/area/ruin/powered)
"Er" = (
/obj/structure/dresser,
/obj/effect/decal/cleanable/cobweb,
/turf/open/floor/wood,
/area/ruin/powered)
"Ew" = (
/mob/living/simple_animal/parrot,
/obj/structure/table/wood/poker,
/obj/effect/decal/cleanable/cobweb/cobweb2,
/turf/open/floor/wood,
/area/ruin/powered)
"Ic" = (
/obj/effect/turf_decal/siding/wood{
	dir = 4
	},
/turf/open/floor/plating/dirt/jungle,
/area/ruin/powered)
"IH" = (
/obj/item/reagent_containers/glass/bucket/wooden,
/turf/open/floor/wood,
/area/ruin/powered)
"Kd" = (
/obj/structure/fermenting_barrel,
/turf/open/floor/wood,
/area/ruin/powered)
"Kl" = (
/turf/open/floor/plating/dirt/jungle/dark,
/area/ruin/powered)
"KD" = (
/obj/machinery/grill,
/obj/effect/decal/cleanable/dirt,
/obj/effect/decal/cleanable/blood/old,
/turf/open/floor/wood,
/area/ruin/powered)
"LD" = (
/obj/item/ammo_box/n762,
/obj/structure/table/wood/poker,
/turf/open/floor/wood,
/area/ruin/powered)
"LT" = (
/mob/living/simple_animal/hostile/pirate/melee,
/obj/structure/chair/wood,
/obj/effect/decal/cleanable/dirt,
/turf/open/floor/wood,
/area/ruin/powered)
"MX" = (
/obj/machinery/power/emitter/energycannon{
	dir = 8
	},
/turf/open/floor/wood,
/area/ruin/powered)
"Nq" = (
/obj/effect/decal/cleanable/dirt,
/turf/open/water/jungle,
/area/ruin/powered)
"NY" = (
/obj/structure/railing,
/obj/machinery/power/emitter/energycannon,
/obj/effect/decal/cleanable/ash/large,
/turf/open/floor/wood,
/area/ruin/powered)
"Pp" = (
/obj/structure/railing{
	dir = 1
	},
/obj/machinery/power/emitter/energycannon{
	dir = 1
	},
/obj/effect/decal/cleanable/ash,
/turf/open/floor/wood,
/area/ruin/powered)
"PI" = (
/obj/structure/closet/crate/secure/weapon,
/turf/open/floor/wood,
/area/ruin/powered)
"Qq" = (
/turf/template_noop,
/area/template_noop)
"RY" = (
/obj/effect/decal/cleanable/food/flour,
/turf/open/floor/wood,
/area/ruin/powered)
"Sk" = (
/obj/structure/safe,
/turf/open/floor/wood,
/area/ruin/powered)
"SA" = (
/obj/structure/railing,
/turf/open/floor/wood,
/area/ruin/powered)
"Th" = (
/obj/structure/railing{
	dir = 1
	},
/turf/open/floor/wood,
/area/ruin/powered)
"TH" = (
/obj/structure/railing,
/obj/structure/railing{
	dir = 8
	},
/turf/open/floor/wood,
/area/ruin/powered)
"TX" = (
/obj/structure/closet/crate/secure/loot,
/turf/open/floor/wood,
/area/ruin/powered)
"UA" = (
/obj/structure/railing{
	dir = 1
	},
/obj/machinery/power/emitter/energycannon{
	dir = 1
	},
/obj/effect/decal/cleanable/ash/large,
/turf/open/floor/wood,
/area/ruin/powered)
"UR" = (
/obj/effect/turf_decal/siding/wood{
	dir = 8
	},
/turf/open/floor/plating/dirt/jungle,
/area/ruin/powered)
"UX" = (
/mob/living/simple_animal/hostile/pirate/melee,
/turf/open/floor/wood,
/area/ruin/powered)
"Vf" = (
/turf/open/floor/carpet/red,
/area/ruin/powered)
"Wk" = (
/obj/structure/closet/crate/critter,
/obj/effect/decal/cleanable/dirt,
/turf/open/floor/wood,
/area/ruin/powered)
"Wp" = (
/obj/structure/railing/corner{
	dir = 1
	},
/turf/open/floor/wood,
/area/ruin/powered)
"WA" = (
/obj/effect/decal/cleanable/dirt,
/obj/effect/decal/cleanable/oil,
/turf/open/floor/wood,
/area/ruin/powered)
"Xb" = (
/obj/effect/decal/cleanable/dirt,
/turf/open/floor/carpet/red,
/area/ruin/powered)
"Xt" = (
/obj/structure/table/wood/poker,
/obj/item/nullrod/claymore/saber/pirate,
/obj/item/melee/transforming/energy/sword/pirate,
/turf/open/floor/carpet/red,
/area/ruin/powered)
"XA" = (
/mob/living/simple_animal/hostile/pirate/melee,
/obj/effect/decal/cleanable/dirt,
/turf/open/floor/wood,
/area/ruin/powered)
"Zl" = (
/obj/structure/ore_box,
/turf/open/floor/wood,
/area/ruin/powered)
"ZM" = (
/obj/structure/closet/crate/goldcrate,
/obj/effect/decal/cleanable/dirt,
/turf/open/floor/wood,
/area/ruin/powered)

(1,1,1) = {"
Qq
Qq
xd
xd
Kl
Kl
tG
tG
tG
tG
tG
Kl
Kl
Qq
Qq
"}
(2,1,1) = {"
Qq
BV
xd
Kl
Kl
tG
tG
tG
ay
MX
tG
tG
Kl
Kl
Qq
"}
(3,1,1) = {"
Ic
Ic
zN
Kl
tG
tG
tG
tG
sH
sH
tG
tG
tG
Kl
Qq
"}
(4,1,1) = {"
rc
rc
tw
tG
tG
tG
tG
Th
sH
WA
ej
tG
tG
Kl
Qq
"}
(5,1,1) = {"
Zl
sH
tw
tG
tG
tG
jc
Wp
UX
sH
ch
TH
tG
Kl
Kl
"}
(6,1,1) = {"
Kd
sH
tw
tG
tG
tG
UA
sH
sH
sH
sH
gW
tG
tG
Kl
"}
(7,1,1) = {"
ZM
ej
tw
tG
tG
jc
ze
sH
uf
uf
sH
ch
TH
tG
Kl
"}
(8,1,1) = {"
sH
SA
tG
tG
DV
Pp
XA
nD
kh
kh
iC
UX
NY
DV
Kl
"}
(9,1,1) = {"
PI
ej
tG
tG
tG
Th
sH
LD
kh
kh
iw
aR
SA
tG
Kl
"}
(10,1,1) = {"
LT
sH
of
cM
of
WA
sH
sH
oj
sH
sH
sH
sH
tG
tG
"}
(11,1,1) = {"
sH
sH
cM
of
of
IH
gz
RY
KD
xT
sH
lN
gE
tG
tG
"}
(12,1,1) = {"
TX
SA
tG
tG
tG
kh
kh
oX
kh
kh
oX
kh
kh
tG
tG
"}
(13,1,1) = {"
Wk
ej
tG
tG
DV
kh
Er
Xb
qL
Xt
Vf
pd
kh
DV
Kl
"}
(14,1,1) = {"
Kd
SA
tw
tG
tG
kh
eK
DH
Xb
Vf
Vf
ZM
kh
tG
Kl
"}
(15,1,1) = {"
Kd
rc
tw
tG
tG
kh
kh
Ew
sH
sH
Sk
kh
kh
tG
Kl
"}
(16,1,1) = {"
DS
sH
tw
tG
tG
Dm
kh
kh
oX
CG
kh
kh
Dm
tG
Kl
"}
(17,1,1) = {"
UR
UR
jN
Kl
tG
tG
Dm
zk
pR
iY
DC
Dm
tG
Kl
Kl
"}
(18,1,1) = {"
Qq
xd
xd
Kl
tG
tG
tG
tG
tG
Nq
tG
tG
tG
Kl
Qq
"}
(19,1,1) = {"
Qq
BV
xd
Kl
Kl
Kl
tG
tG
tG
tG
tG
tG
Kl
Kl
Qq
"}
(20,1,1) = {"
Qq
Qq
xd
xd
xd
Kl
Kl
Kl
tG
tG
Kl
Kl
Kl
Qq
Qq
"}
