//MAP CONVERTED BY dmm2tgm.py THIS HEADER COMMENT PREVENTS RECONVERSION, DO NOT REMOVE
"a" = (
/obj/structure/holosign/barrier/atmos,
/turf/open/indestructible/permalube,
/area/ruin/powered)
"t" = (
/turf/open/indestructible/permalube,
/area/ruin/powered)
"T" = (
/obj/item/greentext,
/turf/open/indestructible/permalube,
/area/ruin/powered)

(1,1,1) = {"
a
a
a
a
a
"}
(2,1,1) = {"
a
t
t
t
a
"}
(3,1,1) = {"
a
t
T
t
a
"}
(4,1,1) = {"
a
t
t
t
a
"}
(5,1,1) = {"
a
a
a
a
a
"}
