//MAP CONVERTED BY dmm2tgm.py THIS HEADER COMMENT PREVENTS RECONVERSION, DO NOT REMOVE
"a" = (
/turf/template_noop,
/area/template_noop)
"b" = (
/turf/open/floor/holofloor/beach/coast_t{
	dir = 5
	},
/area/ruin/powered/beach)
"c" = (
/obj/structure/fluff/divine/convertaltar,
/obj/item/nullrod/spear/apostle,
/turf/open/floor/plating/beach/sand,
/area/ruin/powered/beach)
"j" = (
/turf/open/floor/plating/beach/sand,
/area/ruin/powered/beach)
"k" = (
/turf/open/floor/holofloor/beach/coast_t{
	dir = 4
	},
/area/ruin/powered/beach)
"m" = (
/turf/open/floor/holofloor/beach/coast_t{
	dir = 9
	},
/area/ruin/powered/beach)
"o" = (
/turf/open/floor/holofloor/beach/water,
/area/ruin/powered/beach)
"y" = (
/obj/structure/fans/tiny/invisible,
/turf/open/floor/plating/beach/sand,
/area/ruin/powered/beach)
"z" = (
/turf/open/floor/holofloor/beach/coast_t{
	dir = 6
	},
/area/ruin/powered/beach)
"B" = (
/turf/open/floor/holofloor/beach/coast_t{
	dir = 1
	},
/area/ruin/powered/beach)
"F" = (
/turf/closed/indestructible/riveted/boss,
/area/ruin/powered/beach)
"G" = (
/turf/open/floor/plating/beach/coastline_b{
	dir = 1
	},
/area/ruin/powered/beach)
"H" = (
/mob/living/simple_animal/hostile/platinum,
/turf/open/floor/holofloor/beach/coast_t,
/area/ruin/powered/beach)
"I" = (
/turf/open/floor/holofloor/beach/coast_t{
	dir = 8
	},
/area/ruin/powered/beach)
"N" = (
/turf/open/floor/holofloor/beach/coast_t{
	dir = 10
	},
/area/ruin/powered/beach)

(1,1,1) = {"
a
a
F
F
F
F
F
F
F
F
F
F
F
a
a
"}
(2,1,1) = {"
a
F
F
o
o
o
o
o
o
G
B
j
F
F
a
"}
(3,1,1) = {"
F
F
o
o
o
o
o
o
o
G
B
j
j
F
F
"}
(4,1,1) = {"
F
o
o
o
o
o
o
o
o
G
B
j
j
j
y
"}
(5,1,1) = {"
F
o
m
I
N
o
o
o
o
G
B
j
j
j
y
"}
(6,1,1) = {"
F
o
B
c
H
o
o
o
o
G
B
j
j
j
y
"}
(7,1,1) = {"
F
o
b
k
z
o
o
o
o
G
B
j
j
j
y
"}
(8,1,1) = {"
F
o
o
o
o
o
o
o
o
G
B
j
j
j
y
"}
(9,1,1) = {"
F
F
o
o
o
o
o
o
o
G
B
j
j
F
F
"}
(10,1,1) = {"
a
F
F
o
o
o
o
o
o
G
B
j
F
F
a
"}
(11,1,1) = {"
a
a
F
F
F
F
F
F
F
F
F
F
F
a
a
"}
