"a" = (/turf/template_noop,/area/template_noop)
"X" = (/turf/closed/mineral/random/high_chance,/area/template_noop)

(1,1,1) = {"
aaXXXaa
aXXXXXa
XXXXXXX
XXXXXXX
XXXXXXX
aXXXXXa
aaXXXaa
"}
