//MAP CONVERTED BY dmm2tgm.py THIS HEADER COMMENT PREVENTS RECONVERSION, DO NOT REMOVE
"a" = (
/turf/template_noop,
/area/template_noop)
"b" = (
/turf/open/floor/carpet/red,
/area/ruin/powered)
"c" = (
/obj/machinery/computer/slot_machine,
/obj/machinery/light{
	dir = 1
	},
/turf/open/floor/mineral/plastitanium,
/area/ruin/powered)
"d" = (
/obj/machinery/porta_turret/syndicate/energy,
/turf/closed/wall/mineral/plastitanium,
/area/ruin/powered)
"e" = (
/obj/structure/table/optable,
/turf/open/floor/mineral/plastitanium,
/area/ruin/powered)
"f" = (
/obj/structure/rack,
/obj/item/clothing/suit/armor/vest/syndicate,
/turf/open/floor/mineral/plastitanium,
/area/ruin/powered)
"g" = (
/obj/machinery/door/airlock/vault{
	req_access_txt = "150"
	},
/turf/open/floor/mineral/plastitanium,
/area/ruin/powered)
"h" = (
/obj/structure/fans/tiny/invisible,
/obj/machinery/door/airlock/highsecurity{
	req_access_txt = "150"
	},
/obj/effect/mapping_helpers/airlock/cyclelink_helper,
/turf/open/floor/mineral/plastitanium,
/area/ruin/powered)
"i" = (
/obj/machinery/door/airlock/vault{
	req_access_txt = "151"
	},
/turf/open/floor/mineral/plastitanium,
/area/ruin/powered)
"j" = (
/obj/machinery/stasis/old,
/turf/open/floor/mineral/plastitanium,
/area/ruin/powered)
"k" = (
/obj/structure/table/wood,
/obj/item/card/id/syndicate_command/captain_id{
	id_type_name = "Chris Taylor's ID card";
	name = "Chris Taylor's ID card";
	registered_name = "Chris Taylor"
	},
/turf/open/floor/carpet/red,
/area/ruin/powered)
"l" = (
/turf/closed/wall/mineral/plastitanium,
/area/ruin/powered)
"m" = (
/obj/structure/rack,
/obj/item/clothing/suit/space/syndicate/black/red,
/obj/item/clothing/head/helmet/space/syndicate/black/red,
/turf/open/floor/mineral/plastitanium,
/area/ruin/powered)
"n" = (
/obj/structure/bed,
/obj/item/bedsheet/syndie,
/obj/structure/curtain/cloth/fancy,
/turf/open/floor/mineral/plastitanium,
/area/ruin/powered)
"o" = (
/mob/living/simple_animal/hostile/syndicate/ranged/space,
/turf/open/floor/mineral/plastitanium,
/area/ruin/powered)
"p" = (
/obj/machinery/light{
	dir = 1
	},
/turf/open/floor/mineral/plastitanium,
/area/ruin/powered)
"q" = (
/mob/living/simple_animal/hostile/syndicate/ranged/smg/space/stormtrooper,
/turf/open/floor/carpet/red,
/area/ruin/powered)
"r" = (
/obj/structure/rack,
/obj/item/pen/edagger,
/obj/machinery/light{
	dir = 1
	},
/turf/open/floor/mineral/plastitanium,
/area/ruin/powered)
"s" = (
/obj/structure/table/wood,
/obj/item/radio/intercom{
	pixel_y = -1
	},
/turf/open/floor/mineral/plastitanium,
/area/ruin/powered)
"t" = (
/obj/structure/table,
/obj/item/storage/backpack/duffelbag/syndie/surgery,
/turf/open/floor/mineral/plastitanium,
/area/ruin/powered)
"u" = (
/turf/open/floor/mineral/plastitanium,
/area/ruin/powered)
"v" = (
/obj/structure/fans/tiny/invisible,
/obj/machinery/door/airlock/highsecurity{
	req_access_txt = "150"
	},
/obj/effect/mapping_helpers/airlock/cyclelink_helper{
	dir = 1
	},
/turf/open/floor/mineral/plastitanium,
/area/ruin/powered)
"w" = (
/obj/structure/table,
/obj/effect/spawner/lootdrop/donkpockets,
/obj/effect/spawner/lootdrop/donkpockets,
/turf/open/floor/mineral/plastitanium,
/area/ruin/powered)
"x" = (
/obj/machinery/vending/boozeomat/syndicate_access,
/turf/open/floor/mineral/plastitanium,
/area/ruin/powered)
"y" = (
/obj/item/bedsheet/syndie,
/obj/structure/bed,
/turf/open/floor/carpet/red,
/area/ruin/powered)
"z" = (
/obj/structure/table/wood,
/obj/item/paper_bin,
/obj/item/pen,
/obj/machinery/light{
	dir = 4
	},
/turf/open/floor/mineral/plastitanium,
/area/ruin/powered)
"A" = (
/obj/structure/table,
/obj/machinery/chem_dispenser/drinks/beer/fullupgrade{
	dir = 8
	},
/turf/open/floor/mineral/plastitanium,
/area/ruin/powered)
"B" = (
/obj/structure/table,
/obj/item/clothing/suit/armor/labcoat/triagetech,
/obj/item/clothing/head/beret/triage,
/obj/machinery/light{
	dir = 4
	},
/turf/open/floor/mineral/plastitanium,
/area/ruin/powered)
"C" = (
/obj/structure/table,
/obj/machinery/microwave{
	pixel_x = -1;
	pixel_y = 5
	},
/turf/open/floor/mineral/plastitanium,
/area/ruin/powered)
"D" = (
/obj/structure/bookcase/random/fiction,
/turf/open/floor/carpet/red,
/area/ruin/powered)
"E" = (
/obj/structure/rack,
/obj/item/pda/syndicate,
/turf/open/floor/mineral/plastitanium,
/area/ruin/powered)
"F" = (
/obj/structure/table,
/obj/item/clothing/accessory/medal/rank/pilot{
	name = "syndicate ENS rank ribbon"
	},
/turf/open/floor/mineral/plastitanium,
/area/ruin/powered)
"G" = (
/obj/structure/table,
/obj/machinery/light,
/turf/open/floor/mineral/plastitanium,
/area/ruin/powered)
"H" = (
/obj/structure/rack,
/obj/item/clothing/under/syndicate/samurai,
/obj/item/nullrod/claymore/katana,
/turf/open/floor/mineral/plastitanium,
/area/ruin/powered)
"I" = (
/obj/structure/chair/comfy/black{
	dir = 4
	},
/turf/open/floor/mineral/plastitanium,
/area/ruin/powered)
"K" = (
/obj/structure/table/wood,
/obj/item/flashlight/lamp{
	pixel_x = -2;
	pixel_y = 13
	},
/obj/item/clothing/accessory/medal/rank/first{
	pixel_x = -6
	},
/turf/open/floor/carpet/red,
/area/ruin/powered)
"L" = (
/mob/living/simple_animal/hostile/syndicate/ranged/smg/space,
/turf/open/floor/mineral/plastitanium,
/area/ruin/powered)
"M" = (
/obj/structure/fans/tiny/invisible,
/obj/machinery/door/airlock/highsecurity{
	req_access_txt = "150"
	},
/turf/open/floor/mineral/plastitanium,
/area/ruin/powered)
"N" = (
/obj/structure/fluff/hedge,
/turf/open/floor/mineral/plastitanium,
/area/ruin/powered)
"O" = (
/obj/structure/fans{
	pixel_y = 31
	},
/obj/structure/table/survival_pod,
/obj/item/card/id/syndicate_command/crew_id,
/turf/open/floor/mineral/plastitanium,
/area/ruin/powered)
"P" = (
/obj/structure/closet/cabinet,
/obj/item/clothing/under/syndicate/bloodred/sleepytime,
/obj/item/clothing/under/syndicate/bloodred/sleepytime,
/obj/item/clothing/under/syndicate/bloodred/sleepytime,
/obj/item/clothing/under/syndicate/bloodred/sleepytime,
/obj/item/clothing/under/syndicate/bloodred/sleepytime,
/obj/item/clothing/under/syndicate/bloodred/sleepytime,
/turf/open/floor/mineral/plastitanium,
/area/ruin/powered)
"Q" = (
/mob/living/simple_animal/hostile/syndicate/melee/sword/space,
/turf/open/floor/mineral/plastitanium,
/area/ruin/powered)
"R" = (
/obj/structure/closet/secure_closet{
	anchored = 1;
	icon_state = "hos";
	name = "First Officer's Locker";
	req_access_txt = "151"
	},
/obj/machinery/light{
	dir = 1
	},
/obj/item/clothing/under/syndicate/suit,
/obj/item/clothing/head/hos/beret/syndicate,
/obj/item/clothing/suit/armor/firstofficer,
/obj/item/clothing/under/suit/helltaker/justice,
/obj/item/lipstick/black,
/obj/item/clothing/gloves/combat,
/obj/item/clothing/under/syndicate/combat,
/turf/open/floor/carpet/red,
/area/ruin/powered)
"S" = (
/obj/machinery/sleeper/syndie{
	dir = 8
	},
/turf/open/floor/mineral/plastitanium,
/area/ruin/powered)
"T" = (
/obj/effect/spawner/structure/window/plasma/reinforced/plastitanium,
/turf/open/floor/mineral/plastitanium,
/area/ruin/powered)
"U" = (
/obj/item/gps/computer{
	pixel_y = 0
	},
/turf/open/floor/mineral/plastitanium,
/area/ruin/powered)
"V" = (
/obj/structure/rack,
/obj/item/clothing/under/syndicate/combat,
/obj/item/clothing/under/syndicate/combat,
/obj/item/clothing/under/syndicate/combat,
/obj/item/clothing/under/syndicate/combat,
/obj/item/clothing/under/syndicate/combat,
/obj/item/clothing/under/syndicate/combat,
/turf/open/floor/mineral/plastitanium,
/area/ruin/powered)
"W" = (
/mob/living/simple_animal/hostile/syndicate/ranged/shotgun/space,
/turf/open/floor/mineral/plastitanium,
/area/ruin/powered)
"X" = (
/obj/structure/table/wood,
/turf/open/floor/mineral/plastitanium,
/area/ruin/powered)
"Y" = (
/obj/structure/rack,
/obj/item/storage/bag/money/vault,
/turf/open/floor/mineral/plastitanium,
/area/ruin/powered)
"Z" = (
/obj/structure/bookcase/random/nonfiction,
/turf/open/floor/carpet/red,
/area/ruin/powered)

(1,1,1) = {"
a
l
d
l
l
l
l
l
l
l
d
l
a
"}
(2,1,1) = {"
l
l
E
f
l
n
n
n
n
n
n
l
l
"}
(3,1,1) = {"
d
Y
u
W
l
u
u
u
u
o
u
C
d
"}
(4,1,1) = {"
l
m
u
u
l
P
o
u
u
u
u
w
l
"}
(5,1,1) = {"
l
r
L
u
l
c
u
u
x
A
F
G
l
"}
(6,1,1) = {"
l
V
u
Q
l
l
l
M
l
l
l
l
l
"}
(7,1,1) = {"
l
H
u
u
g
u
u
u
u
u
h
u
v
"}
(8,1,1) = {"
l
l
l
l
l
l
p
u
u
T
l
l
l
"}
(9,1,1) = {"
l
K
b
y
l
O
u
u
u
T
j
t
l
"}
(10,1,1) = {"
l
k
q
b
i
u
u
Q
u
u
u
e
l
"}
(11,1,1) = {"
d
R
b
b
l
U
u
I
u
T
u
B
d
"}
(12,1,1) = {"
l
l
D
Z
l
N
s
z
X
T
S
l
l
"}
(13,1,1) = {"
a
l
d
l
l
l
l
l
l
l
d
l
a
"}
