//MAP CONVERTED BY dmm2tgm.py THIS HEADER COMMENT PREVENTS RECONVERSION, DO NOT REMOVE
"a" = (
/turf/closed/wall/mineral/titanium/nodiagonal,
/area/ruin/unpowered)
"c" = (
/mob/living/simple_animal/hostile/crystal_monster/boss{
	color = "#9c3535";
	health = 300;
	maxHealth = 300;
	name = "Crimson King"
	},
/obj/structure/chair/bronze,
/turf/open/floor/mineral/plastitanium/red,
/area/ruin/unpowered)
"d" = (
/obj/structure/table/wood/fancy,
/obj/item/organ/cyberimp/arm/gun/laser,
/turf/open/floor/mineral/plastitanium/red,
/area/ruin/unpowered)
"e" = (
/obj/structure/table/wood/fancy,
/obj/item/candle,
/turf/open/floor/mineral/plastitanium/red,
/area/ruin/unpowered)
"j" = (
/obj/structure/statue/bronze/marx,
/turf/open/floor/mineral/plastitanium/red,
/area/ruin/unpowered)
"l" = (
/mob/living/simple_animal/hostile/crystal_monster/thug,
/turf/open/floor/mineral/plastitanium/red,
/area/ruin/unpowered)
"m" = (
/turf/template_noop,
/area/template_noop)
"u" = (
/obj/structure/table/wood/fancy,
/obj/item/organ/cyberimp/brain/anti_drop,
/turf/open/floor/mineral/plastitanium/red,
/area/ruin/unpowered)
"v" = (
/turf/open/floor/mineral/plastitanium/red,
/area/ruin/unpowered)
"w" = (
/obj/structure/table/wood/fancy/red,
/obj/item/hemostat/supermatter,
/turf/open/floor/mineral/plastitanium/red,
/area/ruin/unpowered)
"y" = (
/obj/structure/fluff/divine/convertaltar,
/turf/open/floor/mineral/plastitanium/red,
/area/ruin/unpowered)
"A" = (
/mob/living/simple_animal/hostile/crystal_monster/minion,
/turf/open/floor/mineral/plastitanium/red,
/area/ruin/unpowered)
"B" = (
/obj/structure/table/wood/fancy,
/obj/item/melee/moonlight_greatsword{
	color = "#a8474c";
	force = 21;
	name = "sword of the crimson king"
	},
/turf/open/floor/mineral/plastitanium/red,
/area/ruin/unpowered)
"F" = (
/obj/structure/table/wood/fancy,
/turf/open/floor/mineral/plastitanium/red,
/area/ruin/unpowered)
"G" = (
/obj/structure/table/wood/fancy/red,
/obj/item/gun/energy/laser/captain/ntgold/pistol,
/obj/item/scalpel/supermatter,
/turf/open/floor/mineral/plastitanium/red,
/area/ruin/unpowered)
"J" = (
/obj/structure/chair/pew/left{
	dir = 1
	},
/turf/open/floor/mineral/plastitanium/red,
/area/ruin/unpowered)
"K" = (
/mob/living/simple_animal/hostile/crystal_monster/killer,
/turf/open/floor/mineral/plastitanium/red,
/area/ruin/unpowered)
"L" = (
/obj/structure/mecha_wreckage/honker/dark,
/turf/open/floor/mineral/plastitanium/red,
/area/ruin/unpowered)
"M" = (
/obj/structure/curtain/cloth/fancy,
/turf/open/floor/mineral/plastitanium/red,
/area/ruin/unpowered)
"N" = (
/obj/effect/decal/remains/xeno,
/turf/open/floor/mineral/plastitanium/red,
/area/ruin/unpowered)
"O" = (
/obj/structure/table/wood/fancy,
/obj/item/organ/cyberimp/arm/esword,
/turf/open/floor/mineral/plastitanium/red,
/area/ruin/unpowered)
"P" = (
/obj/structure/table/wood/fancy,
/obj/item/bodypart/head/alien{
	pixel_y = 3
	},
/obj/item/candle{
	pixel_x = 4
	},
/obj/item/candle{
	pixel_x = 8;
	pixel_y = 9
	},
/obj/item/candle{
	pixel_y = 14
	},
/obj/item/candle{
	pixel_x = -8;
	pixel_y = 9
	},
/obj/item/candle{
	pixel_x = -4
	},
/turf/open/floor/mineral/plastitanium/red,
/area/ruin/unpowered)
"R" = (
/obj/structure/chair/pew/right{
	dir = 1
	},
/turf/open/floor/mineral/plastitanium/red,
/area/ruin/unpowered)
"S" = (
/mob/living/simple_animal/hostile/crystal_monster/recruit,
/turf/open/floor/mineral/plastitanium/red,
/area/ruin/unpowered)
"T" = (
/obj/structure/mecha_wreckage/seraph,
/turf/open/floor/mineral/plastitanium/red,
/area/ruin/unpowered)
"U" = (
/obj/structure/fluff/divine/powerpylon,
/turf/open/floor/mineral/plastitanium/red,
/area/ruin/unpowered)
"V" = (
/obj/structure/constructshell,
/turf/open/floor/mineral/plastitanium/red,
/area/ruin/unpowered)
"Z" = (
/obj/structure/mineral_door/silver,
/turf/open/floor/mineral/plastitanium/red,
/area/ruin/unpowered)

(1,1,1) = {"
a
a
a
a
a
a
a
a
a
a
"}
(2,1,1) = {"
a
V
v
v
J
a
K
v
v
a
"}
(3,1,1) = {"
a
G
v
v
R
a
v
v
K
a
"}
(4,1,1) = {"
a
y
N
c
v
v
v
v
v
a
"}
(5,1,1) = {"
a
w
v
v
J
a
v
v
v
a
"}
(6,1,1) = {"
a
V
v
v
R
a
v
v
v
a
"}
(7,1,1) = {"
a
a
a
a
a
a
v
v
v
a
"}
(8,1,1) = {"
a
U
v
v
v
v
v
v
v
a
"}
(9,1,1) = {"
a
v
v
v
v
v
v
v
j
a
"}
(10,1,1) = {"
a
v
v
v
a
a
a
a
a
a
"}
(11,1,1) = {"
a
v
v
v
a
l
v
B
F
a
"}
(12,1,1) = {"
a
v
A
v
a
v
v
K
O
a
"}
(13,1,1) = {"
a
v
v
v
M
v
v
v
F
a
"}
(14,1,1) = {"
a
v
v
v
a
v
v
v
d
a
"}
(15,1,1) = {"
a
v
v
A
a
L
v
l
F
a
"}
(16,1,1) = {"
a
v
v
v
a
a
a
a
a
a
"}
(17,1,1) = {"
a
v
v
v
v
v
v
v
u
a
"}
(18,1,1) = {"
a
v
v
v
v
v
v
v
F
a
"}
(19,1,1) = {"
a
v
v
v
v
S
v
v
F
a
"}
(20,1,1) = {"
a
v
S
v
v
v
v
a
a
a
"}
(21,1,1) = {"
a
v
v
v
v
v
v
P
e
a
"}
(22,1,1) = {"
a
v
v
v
v
v
v
v
v
Z
"}
(23,1,1) = {"
a
v
v
v
v
v
v
v
v
Z
"}
(24,1,1) = {"
a
a
v
S
v
v
v
S
T
a
"}
(25,1,1) = {"
m
a
a
a
a
a
a
a
a
a
"}
