//MAP CONVERTED BY dmm2tgm.py THIS HEADER COMMENT PREVENTS RECONVERSION, DO NOT REMOVE
"a" = (
/turf/open/genturf,
/area/space)
"b" = (
/obj/structure/stone_tile/block,
/turf/open/indestructible/cult,
/area/space)
"c" = (
/obj/structure/stone_tile/block{
	dir = 4
	},
/turf/open/indestructible/cult,
/area/space)
"d" = (
/obj/structure/stone_tile/block{
	dir = 1
	},
/turf/open/indestructible/cult,
/area/space)
"e" = (
/obj/structure/stone_tile/block{
	dir = 8
	},
/turf/open/floor/plating/asteroid/snow/ice/icemoon,
/area/space)
"i" = (
/obj/structure/stone_tile/block,
/obj/structure/stone_tile/cracked{
	dir = 4
	},
/turf/open/lava/plasma/ice_moon,
/area/space)
"k" = (
/turf/open/indestructible/cult,
/area/space)
"l" = (
/obj/structure/stone_tile/cracked{
	dir = 8
	},
/obj/structure/stone_tile{
	dir = 1
	},
/turf/open/indestructible/cult,
/area/space)
"o" = (
/obj/structure/stone_tile{
	dir = 1
	},
/obj/structure/stone_tile/block/cracked,
/turf/open/lava/plasma/ice_moon,
/area/space)
"s" = (
/obj/structure/stone_tile/block/cracked{
	dir = 4
	},
/turf/open/indestructible/cult,
/area/space)
"t" = (
/obj/structure/stone_tile/cracked,
/turf/open/indestructible/cult,
/area/space)
"u" = (
/obj/structure/stone_tile{
	dir = 8
	},
/turf/open/indestructible/cult,
/area/space)
"v" = (
/turf/open/floor/plating/asteroid/snow/ice/icemoon,
/area/space)
"w" = (
/obj/structure/stone_tile/surrounding/cracked{
	dir = 6
	},
/mob/living/simple_animal/hostile/megafauna/demonic_frost_miner,
/turf/open/lava/plasma/ice_moon,
/area/space)
"x" = (
/obj/structure/stone_tile/block/cracked{
	dir = 1
	},
/turf/open/indestructible/cult,
/area/space)
"z" = (
/obj/structure/stone_tile/block/cracked{
	dir = 1
	},
/turf/open/floor/plating/asteroid/snow/ice/icemoon,
/area/space)
"C" = (
/obj/structure/stone_tile{
	dir = 8
	},
/turf/open/floor/plating/asteroid/snow/ice/icemoon,
/area/space)
"E" = (
/obj/structure/stone_tile/cracked{
	dir = 1
	},
/turf/open/indestructible/cult,
/area/space)
"F" = (
/obj/structure/stone_tile,
/obj/structure/stone_tile/block/cracked{
	dir = 8
	},
/turf/open/lava/plasma/ice_moon,
/area/space)
"H" = (
/obj/structure/stone_tile/cracked{
	dir = 4
	},
/turf/open/indestructible/cult,
/area/space)
"M" = (
/obj/structure/stone_tile,
/obj/structure/stone_tile{
	dir = 4
	},
/turf/open/indestructible/cult,
/area/space)
"N" = (
/obj/structure/stone_tile/block{
	dir = 8
	},
/turf/open/indestructible/cult,
/area/space)
"O" = (
/obj/structure/stone_tile{
	dir = 4
	},
/obj/structure/stone_tile/cracked,
/turf/open/indestructible/cult,
/area/space)
"Q" = (
/turf/closed/indestructible/rock/snow/ice/ore,
/area/space)
"R" = (
/obj/structure/stone_tile{
	dir = 4
	},
/turf/open/indestructible/cult,
/area/space)
"S" = (
/obj/structure/stone_tile,
/turf/open/floor/plating/asteroid/snow/ice/icemoon,
/area/space)
"T" = (
/obj/structure/stone_tile{
	dir = 4
	},
/obj/structure/stone_tile{
	dir = 1
	},
/turf/open/lava/plasma/ice_moon,
/area/space)
"U" = (
/obj/structure/stone_tile/cracked{
	dir = 8
	},
/turf/open/indestructible/cult,
/area/space)
"V" = (
/turf/closed/wall/mineral/cult,
/area/space)
"Z" = (
/obj/structure/stone_tile{
	dir = 8
	},
/obj/structure/stone_tile/block{
	dir = 1
	},
/turf/open/floor/plating/asteroid/snow/ice/icemoon,
/area/space)

(1,1,1) = {"
a
a
a
a
a
a
a
a
a
a
a
a
a
a
a
a
a
a
a
a
a
a
a
a
a
a
a
a
a
a
"}
(2,1,1) = {"
a
a
a
a
a
a
a
a
a
a
a
a
a
a
a
a
a
a
a
a
a
a
a
a
a
a
a
a
a
a
"}
(3,1,1) = {"
a
a
a
a
a
a
a
a
a
a
a
a
a
a
a
a
a
a
a
a
a
a
a
a
a
a
a
a
a
a
"}
(4,1,1) = {"
a
a
a
a
a
a
a
a
a
a
a
a
a
a
a
a
a
a
a
a
a
a
a
a
a
a
a
a
a
a
"}
(5,1,1) = {"
a
a
a
a
a
a
a
a
a
V
V
V
V
V
V
V
V
V
a
a
a
a
a
a
a
a
a
a
a
a
"}
(6,1,1) = {"
a
a
a
a
a
a
a
a
V
V
V
V
V
V
V
V
V
V
V
a
a
a
a
a
a
a
a
a
a
a
"}
(7,1,1) = {"
a
a
a
a
a
a
a
V
V
Q
Q
Q
Q
Q
Q
Q
Q
Q
V
V
a
a
a
a
a
a
a
a
a
a
"}
(8,1,1) = {"
a
a
a
a
a
a
V
V
Q
Q
Q
k
k
k
k
k
k
Q
Q
V
V
a
a
a
a
a
a
a
a
a
"}
(9,1,1) = {"
a
a
a
a
a
V
V
Q
Q
k
k
k
k
k
k
k
k
k
Q
Q
V
V
a
a
a
a
a
a
a
a
"}
(10,1,1) = {"
a
a
a
a
V
V
Q
Q
k
k
k
k
k
k
k
k
k
k
k
Q
Q
V
V
V
a
a
a
a
a
a
"}
(11,1,1) = {"
a
a
a
V
V
Q
Q
k
k
k
k
k
N
k
k
k
k
k
k
k
Q
Q
V
V
V
a
a
a
a
a
"}
(12,1,1) = {"
a
a
a
V
V
Q
k
k
k
k
k
k
H
b
k
k
k
v
k
k
k
Q
Q
V
V
a
a
k
a
a
"}
(13,1,1) = {"
a
a
a
V
V
Q
k
k
k
k
e
U
v
x
v
O
v
k
k
k
k
k
k
k
k
a
k
a
a
a
"}
(14,1,1) = {"
a
a
a
V
V
Q
k
k
k
k
k
c
M
C
i
S
k
N
u
k
k
k
k
k
k
k
k
k
a
k
"}
(15,1,1) = {"
a
a
a
V
V
Q
k
k
k
k
k
k
v
T
w
F
Z
t
z
u
k
k
k
k
k
k
k
k
k
a
"}
(16,1,1) = {"
a
a
a
V
V
Q
k
k
k
k
u
R
l
S
o
C
k
E
N
t
k
k
k
k
k
k
a
k
k
a
"}
(17,1,1) = {"
a
a
a
V
V
Q
k
k
k
k
E
S
k
d
v
b
k
k
k
k
k
k
Q
V
V
a
k
a
a
a
"}
(18,1,1) = {"
a
a
a
V
V
Q
Q
k
k
k
k
k
k
b
k
k
v
k
k
k
k
Q
Q
V
V
a
a
k
a
a
"}
(19,1,1) = {"
a
a
a
a
V
V
Q
Q
k
k
k
k
s
k
k
k
k
k
k
k
Q
Q
V
V
a
a
a
a
a
a
"}
(20,1,1) = {"
a
a
a
a
a
V
V
Q
Q
k
k
k
k
k
k
k
k
k
k
Q
Q
V
V
a
a
a
a
a
a
a
"}
(21,1,1) = {"
a
a
a
a
a
a
V
V
Q
Q
k
k
k
k
k
k
k
k
Q
Q
V
V
a
a
a
a
a
a
a
a
"}
(22,1,1) = {"
a
a
a
a
a
a
a
V
V
Q
Q
k
k
k
k
k
k
Q
Q
V
V
a
a
a
a
a
a
a
a
a
"}
(23,1,1) = {"
a
a
a
a
a
a
a
a
V
V
Q
Q
Q
Q
Q
Q
Q
Q
V
V
a
a
a
a
a
a
a
a
a
a
"}
(24,1,1) = {"
a
a
a
a
a
a
a
a
a
V
V
V
V
V
V
V
V
V
V
a
a
a
a
a
a
a
a
a
a
a
"}
(25,1,1) = {"
a
a
a
a
a
a
a
a
a
a
V
V
V
V
V
V
V
V
a
a
a
a
a
a
a
a
a
a
a
a
"}
(26,1,1) = {"
a
a
a
a
a
a
a
a
a
a
a
a
a
a
a
a
a
a
a
a
a
a
a
a
a
a
a
a
a
a
"}
(27,1,1) = {"
a
a
a
a
a
a
a
a
a
a
a
a
a
a
a
a
a
a
a
a
a
a
a
a
a
a
a
a
a
a
"}
(28,1,1) = {"
a
a
a
a
a
a
a
a
a
a
a
a
a
a
a
a
a
a
a
a
a
a
a
a
a
a
a
a
a
a
"}
(29,1,1) = {"
a
a
a
a
a
a
a
a
a
a
a
a
a
a
a
a
a
a
a
a
a
a
a
a
a
a
a
a
a
a
"}
(30,1,1) = {"
a
a
a
a
a
a
a
a
a
a
a
a
a
a
a
a
a
a
a
a
a
a
a
a
a
a
a
a
a
a
"}
