//MAP CONVERTED BY dmm2tgm.py THIS HEADER COMMENT PREVENTS RECONVERSION, DO NOT REMOVE
"a" = (
/turf/template_noop,
/area/template_noop)
"c" = (
/obj/structure/stone_tile/block{
	dir = 8
	},
/turf/open/floor/plating/asteroid/snow/ice/icemoon,
/area/icemoon/underground/explored)
"d" = (
/obj/structure/stone_tile{
	dir = 8
	},
/turf/open/indestructible/cult,
/area/icemoon/underground/explored)
"e" = (
/obj/structure/stone_tile/cracked{
	dir = 1
	},
/turf/open/indestructible/cult,
/area/icemoon/underground/explored)
"g" = (
/obj/structure/stone_tile/block/cracked{
	dir = 1
	},
/turf/open/floor/plating/asteroid/snow/ice/icemoon,
/area/icemoon/underground/explored)
"i" = (
/obj/structure/stone_tile/cracked{
	dir = 8
	},
/turf/open/indestructible/cult,
/area/icemoon/underground/explored)
"k" = (
/turf/open/indestructible/cult,
/area/icemoon/underground/explored)
"l" = (
/obj/structure/stone_tile/block{
	dir = 4
	},
/turf/open/indestructible/cult,
/area/icemoon/underground/explored)
"o" = (
/obj/structure/stone_tile{
	dir = 4
	},
/turf/open/indestructible/cult,
/area/icemoon/underground/explored)
"s" = (
/obj/structure/stone_tile/block{
	dir = 8
	},
/turf/open/indestructible/cult,
/area/icemoon/underground/explored)
"t" = (
/obj/structure/stone_tile/cracked{
	dir = 4
	},
/turf/open/indestructible/cult,
/area/icemoon/underground/explored)
"u" = (
/obj/structure/stone_tile,
/obj/structure/stone_tile{
	dir = 4
	},
/turf/open/indestructible/cult,
/area/icemoon/underground/explored)
"v" = (
/turf/open/floor/plating/asteroid/snow/ice/icemoon,
/area/icemoon/underground/explored)
"w" = (
/obj/structure/stone_tile/block/cracked{
	dir = 4
	},
/turf/open/indestructible/cult,
/area/icemoon/underground/explored)
"x" = (
/obj/structure/stone_tile/block{
	dir = 1
	},
/turf/open/indestructible/cult,
/area/icemoon/underground/explored)
"z" = (
/obj/structure/stone_tile/block/cracked{
	dir = 1
	},
/turf/open/indestructible/cult,
/area/icemoon/underground/explored)
"A" = (
/obj/structure/stone_tile/cracked,
/turf/open/indestructible/cult,
/area/icemoon/underground/explored)
"E" = (
/obj/structure/stone_tile{
	dir = 8
	},
/turf/open/floor/plating/asteroid/snow/ice/icemoon,
/area/icemoon/underground/explored)
"F" = (
/obj/structure/stone_tile{
	dir = 4
	},
/obj/structure/stone_tile{
	dir = 1
	},
/turf/open/lava/plasma/ice_moon,
/area/icemoon/underground/explored)
"H" = (
/obj/structure/stone_tile/cracked{
	dir = 8
	},
/obj/structure/stone_tile{
	dir = 1
	},
/turf/open/indestructible/cult,
/area/icemoon/underground/explored)
"M" = (
/obj/structure/stone_tile/block,
/obj/structure/stone_tile/cracked{
	dir = 4
	},
/turf/open/lava/plasma/ice_moon,
/area/icemoon/underground/explored)
"N" = (
/obj/structure/stone_tile/surrounding/cracked{
	dir = 6
	},
/mob/living/simple_animal/hostile/megafauna/demonic_frost_miner,
/turf/open/lava/plasma/ice_moon,
/area/icemoon/underground/explored)
"O" = (
/obj/structure/stone_tile/block,
/turf/open/indestructible/cult,
/area/icemoon/underground/explored)
"Q" = (
/turf/closed/indestructible/rock/snow/ice/ore,
/area/icemoon/underground/explored)
"R" = (
/obj/structure/stone_tile{
	dir = 1
	},
/obj/structure/stone_tile/block/cracked,
/turf/open/lava/plasma/ice_moon,
/area/icemoon/underground/explored)
"S" = (
/obj/structure/stone_tile{
	dir = 4
	},
/obj/structure/stone_tile/cracked,
/turf/open/indestructible/cult,
/area/icemoon/underground/explored)
"T" = (
/obj/structure/stone_tile,
/obj/structure/stone_tile/block/cracked{
	dir = 8
	},
/turf/open/lava/plasma/ice_moon,
/area/icemoon/underground/explored)
"U" = (
/obj/structure/stone_tile,
/turf/open/floor/plating/asteroid/snow/ice/icemoon,
/area/icemoon/underground/explored)
"V" = (
/turf/closed/wall/mineral/cult,
/area/icemoon/underground/explored)
"Z" = (
/obj/structure/stone_tile{
	dir = 8
	},
/obj/structure/stone_tile/block{
	dir = 1
	},
/turf/open/floor/plating/asteroid/snow/ice/icemoon,
/area/icemoon/underground/explored)

(1,1,1) = {"
a
a
a
a
a
a
V
V
V
V
V
V
V
V
V
a
a
a
a
a
a
a
a
a
a
a
a
"}
(2,1,1) = {"
a
a
a
a
a
V
V
V
V
V
V
V
V
V
V
V
a
a
a
a
a
a
a
a
a
a
a
"}
(3,1,1) = {"
a
a
a
a
V
V
Q
Q
Q
Q
Q
Q
Q
Q
Q
V
V
a
a
a
a
a
a
a
a
a
a
"}
(4,1,1) = {"
a
a
a
V
V
Q
Q
Q
k
k
k
k
k
k
Q
Q
V
V
a
a
a
a
a
a
a
a
a
"}
(5,1,1) = {"
a
a
V
V
Q
Q
k
k
k
k
k
k
k
k
k
Q
Q
V
V
a
a
a
a
a
a
a
a
"}
(6,1,1) = {"
a
V
V
Q
Q
k
k
k
k
k
k
k
k
k
k
k
Q
Q
V
V
V
a
a
a
a
a
a
"}
(7,1,1) = {"
V
V
Q
Q
k
k
k
k
k
s
k
k
k
k
k
k
k
Q
Q
V
V
V
a
a
a
a
a
"}
(8,1,1) = {"
V
V
Q
k
k
k
k
k
k
t
O
k
k
k
v
k
k
k
Q
Q
V
V
a
a
k
a
a
"}
(9,1,1) = {"
V
V
Q
k
k
k
k
c
i
v
z
v
S
v
k
k
k
k
k
k
k
k
a
k
a
a
a
"}
(10,1,1) = {"
V
V
Q
k
k
k
k
k
l
u
E
M
U
k
s
d
k
k
k
k
k
k
k
k
k
a
k
"}
(11,1,1) = {"
V
V
Q
k
k
k
k
k
k
v
F
N
T
Z
A
g
d
k
k
k
k
k
k
k
k
k
a
"}
(12,1,1) = {"
V
V
Q
k
k
k
k
d
o
H
U
R
E
k
e
s
A
k
k
k
k
k
k
a
k
k
a
"}
(13,1,1) = {"
V
V
Q
k
k
k
k
e
U
k
x
v
O
k
k
k
k
k
k
Q
V
V
a
k
a
a
a
"}
(14,1,1) = {"
V
V
Q
Q
k
k
k
k
k
k
O
k
k
v
k
k
k
k
Q
Q
V
V
a
a
k
a
a
"}
(15,1,1) = {"
a
V
V
Q
Q
k
k
k
k
w
k
k
k
k
k
k
k
Q
Q
V
V
a
a
a
a
a
a
"}
(16,1,1) = {"
a
a
V
V
Q
Q
k
k
k
k
k
k
k
k
k
k
Q
Q
V
V
a
a
a
a
a
a
a
"}
(17,1,1) = {"
a
a
a
V
V
Q
Q
k
k
k
k
k
k
k
k
Q
Q
V
V
a
a
a
a
a
a
a
a
"}
(18,1,1) = {"
a
a
a
a
V
V
Q
Q
k
k
k
k
k
k
Q
Q
V
V
a
a
a
a
a
a
a
a
a
"}
(19,1,1) = {"
a
a
a
a
a
V
V
Q
Q
Q
Q
Q
Q
Q
Q
V
V
a
a
a
a
a
a
a
a
a
a
"}
(20,1,1) = {"
a
a
a
a
a
a
V
V
V
V
V
V
V
V
V
V
a
a
a
a
a
a
a
a
a
a
a
"}
(21,1,1) = {"
a
a
a
a
a
a
a
V
V
V
V
V
V
V
V
a
a
a
a
a
a
a
a
a
a
a
a
"}
