//MAP CONVERTED BY dmm2tgm.py THIS HEADER COMMENT PREVENTS RECONVERSION, DO NOT REMOVE
"a" = (
/turf/template_noop,
/area/template_noop)
"c" = (
/obj/structure/table/bronze,
/obj/item/clothing/head/bronze,
/obj/item/clothing/shoes/bronze,
/obj/item/clothing/suit/bronze,
/turf/open/floor/bronze/icemoon,
/area/ruin/space/has_grav/powered)
"h" = (
/obj/structure/window/bronze/fulltile,
/turf/open/floor/bronze/icemoon,
/area/ruin/space/has_grav/powered)
"j" = (
/obj/structure/table/bronze,
/obj/item/nullrod/spear,
/turf/open/floor/bronze/icemoon,
/area/ruin/space/has_grav/powered)
"m" = (
/obj/structure/fluff/divine/powerpylon{
	color = "#543310";
	light_color = "#543310"
	},
/turf/open/floor/bronze/icemoon,
/area/ruin/space/has_grav/powered)
"A" = (
/turf/closed/wall/mineral/bronze,
/area/ruin/space/has_grav/powered)
"F" = (
/mob/living/simple_animal/hostile/megafauna/clockwork_defender,
/turf/open/floor/bronze/icemoon,
/area/ruin/space/has_grav/powered)
"G" = (
/obj/machinery/door/airlock/bronze,
/turf/open/floor/bronze/icemoon,
/area/ruin/space/has_grav/powered)
"J" = (
/obj/structure/table/bronze,
/obj/item/stack/sheet/bronze{
	amount = 20
	},
/turf/open/floor/bronze/icemoon,
/area/ruin/space/has_grav/powered)
"M" = (
/obj/structure/table/bronze,
/obj/item/organ/ears/bronze,
/obj/item/toy/clockwork_watch,
/turf/open/floor/bronze/icemoon,
/area/ruin/space/has_grav/powered)
"N" = (
/obj/structure/table/bronze,
/obj/item/reagent_containers/food/drinks/trophy/bronze_cup{
	pixel_y = 7
	},
/turf/open/floor/bronze/icemoon,
/area/ruin/space/has_grav/powered)
"Q" = (
/obj/structure/fluff/clockwork/fallen_armor,
/turf/open/floor/bronze/icemoon,
/area/ruin/space/has_grav/powered)
"T" = (
/turf/open/floor/bronze/icemoon,
/area/ruin/space/has_grav/powered)
"X" = (
/obj/structure/fluff/clockwork/alloy_shards,
/turf/open/floor/bronze/icemoon,
/area/ruin/space/has_grav/powered)
"Y" = (
/obj/structure/fluff/clockwork/clockgolem_remains,
/turf/open/floor/bronze/icemoon,
/area/ruin/space/has_grav/powered)

(1,1,1) = {"
a
h
h
h
h
h
h
h
a
"}
(2,1,1) = {"
h
h
m
T
T
Q
m
h
h
"}
(3,1,1) = {"
h
N
X
T
Y
X
T
m
A
"}
(4,1,1) = {"
h
J
T
Y
T
T
T
T
A
"}
(5,1,1) = {"
h
c
T
T
F
T
T
T
G
"}
(6,1,1) = {"
h
M
Y
T
T
T
Y
T
A
"}
(7,1,1) = {"
h
j
T
X
T
T
Q
m
A
"}
(8,1,1) = {"
h
h
m
Q
T
T
m
h
h
"}
(9,1,1) = {"
a
h
h
h
h
h
h
h
a
"}
