//MAP CONVERTED BY dmm2tgm.py THIS HEADER COMMENT PREVENTS RECONVERSION, DO NOT REMOVE
"a" = (
/turf/template_noop,
/area/template_noop)
"b" = (
/obj/item/construction/rcd/combat/admin{
	name = "Caels RCD"
	},
/obj/item/melee/transforming/energy/axe{
	name = "Caels Axe"
	},
/obj/item/door_remote/omni{
	name = "Caels Remote"
	},
/obj/item/instrument/piano_synth{
	name = "Caels Synthesizer"
	},
/obj/item/gun/energy/e_gun/advtaser{
	cell_type = /obj/item/stock_parts/cell/infinite;
	name = "Caels Taser"
	},
/obj/item/reagent_containers/syringe/bluespace{
	name = "Caels Syringe"
	},
/obj/structure/closet/cabinet{
	name = "Caels cabinet"
	},
/obj/item/inducer/syndicate{
	name = "Caels inducer"
	},
/obj/effect/turf_decal/siding/wood{
	dir = 1
	},
/turf/open/floor/wood,
/area/ruin/powered)
"d" = (
/obj/machinery/recharger{
	pixel_x = -9
	},
/obj/structure/table/wood/fancy/purple,
/obj/machinery/cell_charger{
	pixel_y = 14
	},
/obj/item/stock_parts/cell/infinite/abductor{
	pixel_x = 3;
	pixel_y = -3
	},
/obj/item/stock_parts/cell/infinite/abductor{
	pixel_x = 3
	},
/obj/item/stock_parts/cell/infinite/abductor{
	pixel_x = 3;
	pixel_y = 3
	},
/turf/open/floor/carpet/purple,
/area/ruin/powered)
"g" = (
/obj/item/soap/omega,
/obj/item/megaphone,
/obj/item/mop/advanced,
/obj/structure/table/wood/fancy/purple,
/obj/item/radio,
/obj/item/lightreplacer{
	max_uses = 2000;
	uses = 2000
	},
/obj/item/construction/rld/mini{
	max_matter = 2000
	},
/obj/item/storage/bag/trash/bluespace,
/obj/structure/sign/poster/contraband/abs{
	pixel_x = -32
	},
/obj/machinery/button{
	desc = "Doesnt actually do anything, but its fun to press.";
	name = "Panic Button";
	pixel_y = -26
	},
/turf/open/floor/carpet/purple,
/area/ruin/powered)
"h" = (
/obj/item/bedsheet/wiz,
/obj/structure/bed,
/obj/machinery/shower{
	dir = 8;
	layer = 4;
	name = "emergency shower";
	pixel_y = 8
	},
/obj/item/clothing/head/wizard/marisa{
	name = "Caels spare witch hat"
	},
/turf/open/floor/carpet/purple,
/area/ruin/powered)
"i" = (
/mob/living/simple_animal/pet/dog/pug/mcgriff{
	desc = "Unrelated to the McGriff family line";
	name = "McDrip"
	},
/obj/structure/bed/dogbed/mcgriff,
/obj/item/clothing/shoes/swagshoes{
	layer = 6;
	pixel_x = -3;
	pixel_y = -14
	},
/obj/item/clothing/under/costume/swagoutfit{
	pixel_y = -11
	},
/obj/item/instrument/piano_synth/headphones{
	pixel_x = 1;
	pixel_y = -2
	},
/obj/item/clothing/glasses/sunglasses{
	layer = 5;
	pixel_x = 2;
	pixel_y = -3
	},
/obj/item/stack/spacecash/c10000{
	layer = 2.9
	},
/turf/open/floor/carpet/purple,
/area/ruin/powered)
"j" = (
/obj/item/storage/box/debugtools{
	pixel_x = -8;
	pixel_y = 8
	},
/obj/structure/table/wood/fancy/purple,
/obj/item/storage/box/stabilized{
	pixel_x = -8
	},
/obj/item/storage/box/syndie_kit/chameleon{
	pixel_x = 7;
	pixel_y = 8
	},
/obj/item/storage/box/syndieballoons{
	pixel_x = 7
	},
/obj/effect/turf_decal/siding/wood,
/turf/open/floor/wood,
/area/ruin/powered)
"n" = (
/obj/item/holosign_creator/atmos{
	max_signs = 9001;
	name = "CHADMOS holofan projector"
	},
/obj/item/forcefield_projector{
	max_fields = 9001;
	name = "CHADFIELD projector";
	pixel_y = 3
	},
/obj/structure/table/wood/fancy/purple,
/obj/structure/sign/poster/contraband/lusty_xenomorph{
	pixel_y = 32
	},
/obj/item/holobed_projector{
	max_buckled_mobs = 5;
	name = "CHADBED projector";
	pixel_y = 6
	},
/obj/item/extinguisher/advanced{
	max_water = 1000;
	pixel_x = 12;
	pixel_y = -5
	},
/obj/effect/turf_decal/siding/wood,
/obj/item/holosign_creator{
	max_signs = 9001;
	name = "IM WALKING HERE";
	pixel_y = 9
	},
/obj/item/toy/crayon/spraycan/infinite,
/turf/open/floor/wood,
/area/ruin/powered)
"r" = (
/turf/open/floor/carpet/purple,
/area/ruin/powered)
"w" = (
/obj/structure/closet/cabinet,
/obj/item/storage/backpack/duffelbag/syndie,
/obj/item/card/id/debug,
/obj/item/card/mining_access_card,
/obj/item/mining_voucher,
/obj/item/card/id/departmental_budget/car,
/obj/structure/sign/poster/official/moth9{
	pixel_x = 32
	},
/turf/open/floor/carpet/purple,
/area/ruin/powered)
"y" = (
/obj/item/gun/magic/wand/resurrection/debug,
/obj/item/gun/magic/wand{
	pixel_y = 3
	},
/obj/item/gun/magic/wand/death/debug{
	pixel_y = 6
	},
/obj/item/sharpener/super{
	pixel_y = -5
	},
/obj/item/kitchen/knife/rainbowknife,
/obj/item/gun/energy/laser/instakill,
/obj/item/storage/belt/wands,
/obj/structure/closet{
	icon_state = "shotguncase";
	name = "'Fun' tools"
	},
/obj/item/gun/energy/shrink_ray,
/obj/item/energy_katana,
/obj/item/banhammer{
	desc = "A Xanhammer";
	force = 0;
	name = "Xanhammer"
	},
/obj/item/melee/twistedtea/unlimited{
	desc = "Find out";
	name = "Fuck around"
	},
/obj/effect/turf_decal/siding/wood{
	dir = 1
	},
/turf/open/floor/wood,
/area/ruin/powered)
"A" = (
/obj/item/defibrillator/loaded,
/obj/structure/table/wood/fancy/purple,
/obj/item/pinpointer/crew,
/obj/item/healthanalyzer/advanced,
/obj/item/sensor_device,
/obj/machinery/newscaster{
	pixel_x = -32
	},
/obj/item/shears{
	pixel_y = -9
	},
/obj/item/shockpaddles/syndicate/cyborg,
/obj/item/gun/medbeam,
/obj/item/cautery/advanced{
	pixel_y = -9
	},
/obj/item/bonesetter{
	pixel_y = -7
	},
/obj/item/retractor/advanced{
	pixel_y = 14
	},
/obj/item/scalpel/advanced{
	pixel_y = 12
	},
/turf/open/floor/carpet/purple,
/area/ruin/powered)
"B" = (
/obj/structure/fireplace,
/obj/item/reagent_containers/food/drinks/bottle/vodka/badminka{
	name = "Xanminka vodka";
	pixel_x = 10;
	pixel_y = 46
	},
/obj/item/flashlight/lantern/syndicate{
	icon_state = "syndilantern-on";
	pixel_x = -10;
	pixel_y = 42
	},
/obj/effect/turf_decal/siding/wood,
/turf/open/floor/wood,
/area/ruin/powered)
"C" = (
/obj/machinery/rnd/production/protolathe,
/obj/item/storage/part_replacer/bluespace/tier4{
	pixel_y = 3
	},
/obj/item/storage/part_replacer/bluespace/tier5,
/obj/effect/turf_decal/siding/wood{
	dir = 1
	},
/turf/open/floor/wood,
/area/ruin/powered)
"I" = (
/obj/structure/fluff/fokoff_sign{
	desc = "To the ghosts reading this:"
	},
/mob/living/simple_animal/drone/snowflake{
	health = 69420;
	laws = "1. Your goals are to actively build, maintain, repair, improve, and provide power to the best of your abilities within the facility that housed your activation. And have a nice day :)";
	name = "C.A.E.L."
	},
/turf/open/floor/carpet/purple,
/area/ruin/powered)
"K" = (
/obj/structure/dresser,
/obj/item/toy/plush/moth/rd{
	pixel_y = 16
	},
/obj/structure/sink{
	pixel_y = 20
	},
/obj/item/clothing/accessory/medal/plasma{
	desc = "Good boy award";
	name = "Caels Medal"
	},
/turf/open/floor/carpet/purple,
/area/ruin/powered)
"U" = (
/obj/structure/table/wood/fancy/purple,
/obj/item/storage/backpack/holding{
	pixel_y = 6
	},
/turf/open/floor/carpet/purple,
/area/ruin/powered)
"V" = (
/turf/closed/indestructible/wood,
/area/ruin/powered)
"X" = (
/obj/item/storage/belt/medical/surgeryfilled,
/obj/item/storage/belt/utility/chief/full{
	pixel_y = 3
	},
/obj/structure/table/wood/fancy/purple,
/obj/item/radio/intercom{
	pixel_x = -32
	},
/obj/item/plaque{
	desc = "You shouldnt be looking at this.";
	name = "Caels Haven Bag";
	pixel_y = 32
	},
/obj/item/storage/belt/janitor/full{
	pixel_y = 6
	},
/turf/open/floor/carpet/purple,
/area/ruin/powered)

(1,1,1) = {"
a
V
V
V
V
V
a
"}
(2,1,1) = {"
V
V
X
A
g
V
V
"}
(3,1,1) = {"
V
n
U
r
d
b
V
"}
(4,1,1) = {"
V
B
r
I
r
y
V
"}
(5,1,1) = {"
V
j
i
r
r
C
V
"}
(6,1,1) = {"
V
V
K
h
w
V
V
"}
(7,1,1) = {"
a
V
V
V
V
V
a
"}
