//MAP CONVERTED BY dmm2tgm.py THIS HEADER COMMENT PREVENTS RECONVERSION, DO NOT REMOVE
"cf" = (
/obj/structure/table,
/obj/machinery/light/small{
	dir = 8
	},
/turf/open/floor/plating,
/area/crew_quarters/devious_lick)
"iH" = (
/obj/machinery/power/apc{
	dir = 4;
	name = "Pubby Bathrooms";
	pixel_x = 24
	},
/obj/structure/cable,
/obj/machinery/atmospherics/pipe/simple/scrubbers/hidden/layer2,
/turf/open/floor/plasteel/freezer,
/area/crew_quarters/devious_lick)
"jj" = (
/obj/machinery/atmospherics/pipe/simple/scrubbers/hidden/layer2{
	dir = 8
	},
/turf/open/floor/plating{
	icon_state = "platingdmg1"
	},
/area/crew_quarters/devious_lick)
"jm" = (
/obj/machinery/light{
	dir = 4
	},
/obj/structure/chair/comfy/black,
/obj/item/toy/plush/moth/jani,
/turf/open/floor/plasteel/freezer,
/area/crew_quarters/devious_lick)
"jr" = (
/obj/machinery/door/airlock{
	name = "Unit B"
	},
/turf/open/floor/plasteel/freezer,
/area/crew_quarters/devious_lick)
"kO" = (
/obj/machinery/door/airlock{
	name = "Unit 1"
	},
/turf/open/floor/plasteel/freezer,
/area/crew_quarters/devious_lick)
"kS" = (
/obj/machinery/door/airlock{
	name = "Unit 2"
	},
/turf/open/floor/plasteel/freezer,
/area/crew_quarters/devious_lick)
"lZ" = (
/obj/machinery/light_switch{
	pixel_y = 25
	},
/turf/open/floor/plasteel/freezer,
/area/crew_quarters/devious_lick)
"mc" = (
/obj/machinery/atmospherics/components/unary/vent_pump/on/layer4,
/turf/open/floor/plasteel/freezer,
/area/crew_quarters/devious_lick)
"oI" = (
/obj/machinery/atmospherics/pipe/simple/supply/hidden/layer4,
/turf/open/floor/plasteel/freezer,
/area/crew_quarters/devious_lick)
"oW" = (
/obj/structure/sink{
	dir = 4;
	pixel_x = -12;
	pixel_y = 2
	},
/obj/structure/mirror{
	pixel_x = -28
	},
/turf/open/floor/plasteel/freezer,
/area/crew_quarters/devious_lick)
"pe" = (
/obj/machinery/shower{
	dir = 4
	},
/obj/structure/sign/poster/official/no_erp{
	pixel_x = -32
	},
/turf/open/floor/plasteel/freezer,
/area/crew_quarters/devious_lick)
"pQ" = (
/obj/machinery/light{
	dir = 4
	},
/obj/structure/cable,
/obj/machinery/atmospherics/pipe/simple/scrubbers/hidden/layer2,
/turf/open/floor/plasteel/freezer,
/area/crew_quarters/devious_lick)
"qE" = (
/obj/structure/cable,
/obj/machinery/atmospherics/pipe/simple/scrubbers/hidden/layer2{
	dir = 8
	},
/turf/open/floor/plasteel/freezer,
/area/crew_quarters/devious_lick)
"qK" = (
/obj/structure/cable,
/turf/open/floor/plating,
/area/crew_quarters/devious_lick)
"ru" = (
/obj/structure/urinal{
	pixel_y = 32
	},
/obj/machinery/airalarm{
	dir = 8;
	pixel_x = 23
	},
/turf/open/floor/plasteel/freezer,
/area/crew_quarters/devious_lick)
"sH" = (
/obj/machinery/door/airlock{
	name = "Unisex Showers"
	},
/obj/structure/cable,
/obj/machinery/atmospherics/pipe/simple/scrubbers/hidden/layer2{
	dir = 8
	},
/turf/open/floor/plasteel/freezer,
/area/crew_quarters/devious_lick)
"um" = (
/obj/structure/cable,
/obj/machinery/atmospherics/pipe/simple/supply/hidden/layer4{
	dir = 9
	},
/obj/machinery/atmospherics/pipe/simple/scrubbers/hidden/layer2{
	dir = 8
	},
/turf/open/floor/plasteel/freezer,
/area/crew_quarters/devious_lick)
"ux" = (
/turf/open/floor/plating{
	icon_state = "platingdmg2"
	},
/area/crew_quarters/devious_lick)
"vI" = (
/obj/structure/urinal{
	pixel_y = 32
	},
/obj/machinery/portable_atmospherics/scrubber,
/turf/open/floor/plasteel/freezer,
/area/crew_quarters/devious_lick)
"vN" = (
/turf/open/floor/plating,
/area/crew_quarters/devious_lick)
"wv" = (
/obj/machinery/door/airlock{
	name = "Unisex Restrooms"
	},
/obj/structure/fans/tiny,
/turf/open/floor/plasteel/freezer,
/area/crew_quarters/devious_lick)
"wx" = (
/obj/structure/cable,
/obj/machinery/atmospherics/pipe/simple/scrubbers/hidden/layer2{
	dir = 8
	},
/turf/open/floor/plating,
/area/crew_quarters/devious_lick)
"wz" = (
/turf/open/floor/plating{
	icon_state = "platingdmg3"
	},
/area/crew_quarters/devious_lick)
"wQ" = (
/obj/machinery/door/airlock/maintenance{
	req_access_txt = "12"
	},
/obj/structure/cable,
/obj/machinery/atmospherics/pipe/simple/scrubbers/hidden/layer2,
/obj/structure/fans/tiny,
/turf/open/floor/plating,
/area/crew_quarters/devious_lick)
"xE" = (
/obj/structure/cable,
/obj/machinery/atmospherics/pipe/simple/scrubbers/hidden/layer2{
	dir = 6
	},
/turf/open/floor/plasteel/freezer,
/area/crew_quarters/devious_lick)
"xZ" = (
/obj/structure/urinal{
	pixel_y = 32
	},
/turf/open/floor/plasteel/freezer,
/area/crew_quarters/devious_lick)
"yf" = (
/obj/machinery/camera{
	c_tag = "Dormitory Toilets";
	dir = 1
	},
/turf/open/floor/plasteel/freezer,
/area/crew_quarters/devious_lick)
"Cw" = (
/turf/open/floor/plating{
	icon_state = "platingdmg1"
	},
/area/crew_quarters/devious_lick)
"DO" = (
/obj/machinery/atmospherics/components/unary/vent_scrubber/on/layer2,
/obj/item/flashlight/lantern/heirloom_moth,
/turf/open/floor/plasteel/freezer,
/area/crew_quarters/devious_lick)
"Ec" = (
/obj/structure/lattice,
/turf/open/space/basic,
/area/crew_quarters/devious_lick)
"Ex" = (
/obj/structure/sign/departments/restroom{
	pixel_x = 32
	},
/turf/open/floor/plating,
/area/crew_quarters/devious_lick)
"EL" = (
/obj/machinery/recharge_station,
/obj/machinery/light/small{
	dir = 1
	},
/obj/machinery/camera{
	c_tag = "Dormitory Cyborg Recharging Station"
	},
/obj/effect/decal/cleanable/oil,
/turf/open/floor/plasteel/freezer,
/area/crew_quarters/devious_lick)
"FK" = (
/obj/structure/cable,
/obj/machinery/atmospherics/pipe/manifold/supply/hidden/layer4{
	dir = 8
	},
/turf/open/floor/plating{
	icon_state = "panelscorched"
	},
/area/crew_quarters/devious_lick)
"FL" = (
/obj/structure/toilet{
	dir = 8
	},
/obj/machinery/light/small{
	dir = 8
	},
/obj/item/gps/spaceruin,
/turf/open/floor/plasteel/freezer,
/area/crew_quarters/devious_lick)
"Gy" = (
/turf/open/floor/plasteel/freezer,
/area/crew_quarters/devious_lick)
"GJ" = (
/obj/machinery/shower{
	dir = 8
	},
/obj/structure/cable,
/obj/machinery/atmospherics/pipe/simple/scrubbers/hidden/layer2{
	dir = 10
	},
/turf/open/floor/plasteel/freezer,
/area/crew_quarters/devious_lick)
"GR" = (
/obj/structure/cable,
/obj/machinery/atmospherics/pipe/manifold/scrubbers/hidden/layer2,
/turf/open/floor/plasteel/freezer,
/area/crew_quarters/devious_lick)
"Hi" = (
/turf/closed/wall,
/area/crew_quarters/devious_lick)
"HO" = (
/obj/structure/extinguisher_cabinet{
	pixel_x = -24
	},
/turf/open/floor/plasteel/freezer,
/area/crew_quarters/devious_lick)
"Is" = (
/obj/structure/cable,
/obj/machinery/atmospherics/pipe/simple/supply/hidden/layer4{
	dir = 4
	},
/obj/machinery/atmospherics/pipe/simple/scrubbers/hidden/layer2{
	dir = 8
	},
/turf/open/floor/plating,
/area/crew_quarters/devious_lick)
"IB" = (
/turf/open/floor/plating{
	icon_state = "panelscorched"
	},
/area/crew_quarters/devious_lick)
"JO" = (
/obj/structure/cable,
/obj/machinery/atmospherics/pipe/simple/scrubbers/hidden/layer2,
/turf/open/floor/plasteel/freezer,
/area/crew_quarters/devious_lick)
"Mh" = (
/turf/template_noop,
/area/template_noop)
"Ms" = (
/obj/machinery/shower{
	dir = 4
	},
/obj/item/soap/nanotrasen,
/turf/open/floor/plasteel/freezer,
/area/crew_quarters/devious_lick)
"MT" = (
/obj/structure/sign/departments/restroom{
	pixel_y = -32
	},
/turf/open/floor/plating{
	icon_state = "platingdmg2"
	},
/area/crew_quarters/devious_lick)
"NZ" = (
/obj/machinery/light{
	dir = 1
	},
/obj/machinery/atmospherics/pipe/simple/scrubbers/hidden/layer2{
	dir = 8
	},
/obj/structure/cable,
/turf/open/floor/plasteel/freezer,
/area/crew_quarters/devious_lick)
"Oa" = (
/obj/structure/cable,
/obj/machinery/atmospherics/pipe/simple/scrubbers/hidden/layer2{
	dir = 5
	},
/turf/open/floor/plating,
/area/crew_quarters/devious_lick)
"Pa" = (
/obj/machinery/door/airlock{
	name = "Unisex Restrooms"
	},
/obj/structure/cable,
/obj/machinery/atmospherics/pipe/simple/supply/hidden/layer4{
	dir = 4
	},
/obj/machinery/atmospherics/pipe/simple/scrubbers/hidden/layer2{
	dir = 8
	},
/obj/structure/fans/tiny,
/turf/open/floor/plasteel/freezer,
/area/crew_quarters/devious_lick)
"QL" = (
/obj/machinery/shower{
	dir = 8
	},
/obj/structure/cable,
/obj/machinery/atmospherics/pipe/simple/scrubbers/hidden/layer2,
/turf/open/floor/plasteel/freezer,
/area/crew_quarters/devious_lick)
"WC" = (
/obj/structure/toilet{
	dir = 8
	},
/obj/machinery/light/small{
	dir = 8
	},
/turf/open/floor/plasteel/freezer,
/area/crew_quarters/devious_lick)
"WH" = (
/obj/structure/cable,
/turf/open/floor/plating{
	icon_state = "panelscorched"
	},
/area/crew_quarters/devious_lick)
"XT" = (
/obj/machinery/light_switch{
	pixel_x = -25
	},
/turf/open/floor/plasteel/freezer,
/area/crew_quarters/devious_lick)
"Ys" = (
/obj/structure/cable,
/obj/machinery/atmospherics/pipe/simple/scrubbers/hidden/layer2{
	dir = 9
	},
/turf/open/floor/plasteel/freezer,
/area/crew_quarters/devious_lick)
"Zp" = (
/obj/machinery/atmospherics/pipe/simple/supply/hidden/layer4,
/turf/open/floor/plating{
	icon_state = "panelscorched"
	},
/area/crew_quarters/devious_lick)

(1,1,1) = {"
Mh
Mh
Mh
Mh
Mh
Mh
Mh
Mh
Mh
Mh
Mh
Mh
Mh
Mh
Mh
Mh
Mh
Mh
Mh
Mh
Mh
Mh
"}
(2,1,1) = {"
Mh
Mh
Mh
Mh
Mh
Mh
Mh
Mh
Mh
Mh
Mh
Mh
Mh
Mh
Mh
Mh
Mh
Mh
Mh
Mh
Mh
Mh
"}
(3,1,1) = {"
Mh
Mh
Mh
Mh
Mh
Mh
Mh
Mh
Mh
Mh
Mh
Mh
Mh
Ec
Mh
Mh
Mh
Mh
Mh
Mh
Mh
Mh
"}
(4,1,1) = {"
Mh
Mh
Mh
Mh
Mh
Mh
Mh
Mh
Mh
Mh
Mh
Mh
Mh
IB
Ec
Mh
Mh
Mh
Mh
Mh
Mh
Mh
"}
(5,1,1) = {"
Mh
Mh
Mh
Mh
Mh
Mh
Mh
Mh
Mh
Mh
Mh
Ec
wz
WH
Ec
Mh
Mh
Mh
Mh
Mh
Mh
Mh
"}
(6,1,1) = {"
Mh
Mh
Mh
Mh
Mh
Mh
Mh
Mh
Mh
Ec
Ec
ux
Zp
FK
qK
wz
Ec
Mh
Mh
Mh
Mh
Mh
"}
(7,1,1) = {"
Mh
Mh
Mh
Mh
Mh
Mh
Mh
Hi
Hi
Hi
Hi
Hi
Ex
Is
IB
vN
Mh
Mh
Mh
Mh
Mh
Mh
"}
(8,1,1) = {"
Mh
Mh
Mh
Mh
Ec
Ec
MT
Hi
oW
oW
oW
Hi
Hi
Pa
Hi
Hi
Ec
Mh
Mh
Mh
Mh
Mh
"}
(9,1,1) = {"
Mh
Mh
Mh
Mh
Mh
IB
IB
wv
Gy
mc
oI
oI
oI
um
XT
Hi
Ec
Ec
Mh
Mh
Mh
Mh
"}
(10,1,1) = {"
Mh
Mh
Ec
Ec
Ec
Ec
IB
Hi
lZ
xE
JO
pQ
iH
Ys
Gy
Hi
Ec
Ec
Ec
Mh
Mh
Mh
"}
(11,1,1) = {"
Mh
Mh
Mh
Mh
Mh
Mh
Hi
Hi
Hi
qE
yf
Hi
Hi
Hi
jr
Hi
Ec
Mh
Mh
Mh
Mh
Mh
"}
(12,1,1) = {"
Mh
Mh
Mh
Mh
Mh
Mh
Hi
vI
HO
qE
Gy
kO
FL
Hi
EL
Hi
Ec
Mh
Mh
Mh
Mh
Mh
"}
(13,1,1) = {"
Mh
Mh
Mh
Mh
Mh
IB
Hi
xZ
DO
GR
Gy
Hi
Hi
Hi
Hi
Hi
Mh
Mh
Mh
Mh
Mh
Mh
"}
(14,1,1) = {"
Mh
Mh
Mh
Mh
Mh
Mh
Hi
ru
jm
qE
Gy
kS
WC
Hi
IB
wz
Mh
Mh
Mh
Mh
Mh
Mh
"}
(15,1,1) = {"
Mh
Mh
Mh
Mh
Mh
Mh
Hi
Hi
Hi
sH
Hi
Hi
Hi
Hi
IB
Ec
Ec
Ec
Mh
Mh
Mh
Mh
"}
(16,1,1) = {"
Mh
Mh
Mh
Mh
Mh
Mh
Cw
IB
Hi
NZ
pe
Ms
Hi
Cw
Ec
Ec
Mh
Mh
Mh
Mh
Mh
Mh
"}
(17,1,1) = {"
Mh
Mh
Mh
Mh
Mh
Ec
Ec
Cw
Hi
GJ
QL
QL
wQ
Oa
Mh
Mh
Mh
Mh
Mh
Mh
Mh
Mh
"}
(18,1,1) = {"
Mh
Mh
Mh
Mh
Mh
Mh
Mh
Mh
Hi
Hi
Hi
Hi
Hi
wx
Mh
Mh
Mh
Mh
Mh
Mh
Mh
Mh
"}
(19,1,1) = {"
Mh
Mh
Mh
Mh
Mh
Mh
Mh
Mh
Hi
vN
cf
IB
Hi
jj
Mh
Mh
Mh
Mh
Mh
Mh
Mh
Mh
"}
(20,1,1) = {"
Mh
Mh
Mh
Mh
Mh
Mh
Mh
Mh
Hi
Mh
Mh
IB
Mh
Mh
Mh
Mh
Mh
Mh
Mh
Mh
Mh
Mh
"}
(21,1,1) = {"
Mh
Mh
Mh
Mh
Mh
Mh
Mh
Mh
Mh
Mh
Mh
Mh
Mh
Mh
Mh
Mh
Mh
Mh
Mh
Mh
Mh
Mh
"}
(22,1,1) = {"
Mh
Mh
Mh
Mh
Mh
Mh
Mh
Mh
Mh
Mh
Mh
Mh
Mh
Mh
Mh
Mh
Mh
Mh
Mh
Mh
Mh
Mh
"}
