"cf" = (/obj/structure/table,/obj/machinery/light/small{dir = 8},/turf/open/floor/plating,/area/ruin/unpowered/no_grav)
"iH" = (/obj/machinery/power/apc{dir = 4; name = "Pubby Bathrooms"; pixel_x = 24},/obj/structure/cable,/obj/machinery/atmospherics/pipe/simple/scrubbers/hidden/layer2,/turf/open/floor/plasteel/freezer,/area/ruin/powered)
"jj" = (/obj/machinery/atmospherics/pipe/simple/scrubbers/hidden/layer2{dir = 8},/turf/open/floor/plating{icon_state = "platingdmg1"},/area/ruin/unpowered/no_grav)
"jm" = (/obj/machinery/light{dir = 4},/obj/structure/chair/comfy/black,/obj/item/toy/plush/moth/jani,/turf/open/floor/plasteel/freezer,/area/ruin/powered)
"jr" = (/obj/machinery/door/airlock{name = "Unit B"},/turf/open/floor/plasteel/freezer,/area/ruin/powered)
"kO" = (/obj/machinery/door/airlock{name = "Unit 1"},/turf/open/floor/plasteel/freezer,/area/ruin/powered)
"kS" = (/obj/machinery/door/airlock{name = "Unit 2"},/turf/open/floor/plasteel/freezer,/area/ruin/powered)
"lZ" = (/obj/machinery/light_switch{pixel_y = 25},/turf/open/floor/plasteel/freezer,/area/ruin/powered)
"mc" = (/obj/machinery/atmospherics/components/unary/vent_pump/on/layer4,/turf/open/floor/plasteel/freezer,/area/ruin/powered)
"oI" = (/obj/machinery/atmospherics/pipe/simple/supply/hidden/layer4,/turf/open/floor/plasteel/freezer,/area/ruin/powered)
"oW" = (/obj/structure/sink{dir = 4; pixel_x = -12; pixel_y = 2},/obj/structure/mirror{pixel_x = -28},/turf/open/floor/plasteel/freezer,/area/ruin/powered)
"pe" = (/obj/machinery/shower{dir = 4},/obj/structure/sign/poster/official/no_erp{pixel_x = -32},/turf/open/floor/plasteel/freezer,/area/ruin/powered)
"pQ" = (/obj/machinery/light{dir = 4},/obj/structure/cable,/obj/machinery/atmospherics/pipe/simple/scrubbers/hidden/layer2,/turf/open/floor/plasteel/freezer,/area/ruin/powered)
"qE" = (/obj/structure/cable,/obj/machinery/atmospherics/pipe/simple/scrubbers/hidden/layer2{dir = 8},/turf/open/floor/plasteel/freezer,/area/ruin/powered)
"qK" = (/obj/structure/cable,/turf/open/floor/plating,/area/ruin/unpowered/no_grav)
"ru" = (/obj/structure/urinal{pixel_y = 32},/obj/machinery/airalarm{dir = 8; pixel_x = 23},/turf/open/floor/plasteel/freezer,/area/ruin/powered)
"sH" = (/obj/machinery/door/airlock{name = "Unisex Showers"},/obj/structure/cable,/obj/machinery/atmospherics/pipe/simple/scrubbers/hidden/layer2{dir = 8},/turf/open/floor/plasteel/freezer,/area/ruin/powered)
"um" = (/obj/structure/cable,/obj/machinery/atmospherics/pipe/simple/supply/hidden/layer4{dir = 9},/obj/machinery/atmospherics/pipe/simple/scrubbers/hidden/layer2{dir = 8},/turf/open/floor/plasteel/freezer,/area/ruin/powered)
"ux" = (/turf/open/floor/plating{icon_state = "platingdmg2"},/area/ruin/unpowered/no_grav)
"vI" = (/obj/structure/urinal{pixel_y = 32},/obj/machinery/portable_atmospherics/scrubber,/turf/open/floor/plasteel/freezer,/area/ruin/powered)
"vN" = (/turf/open/floor/plating,/area/ruin/unpowered/no_grav)
"wv" = (/obj/machinery/door/airlock{name = "Unisex Restrooms"},/obj/structure/fans/tiny,/turf/open/floor/plasteel/freezer,/area/ruin/powered)
"wx" = (/obj/structure/cable,/obj/machinery/atmospherics/pipe/simple/scrubbers/hidden/layer2{dir = 8},/turf/open/floor/plating,/area/ruin/unpowered/no_grav)
"wz" = (/turf/open/floor/plating{icon_state = "platingdmg3"},/area/ruin/unpowered/no_grav)
"wQ" = (/obj/machinery/door/airlock/maintenance{req_access_txt = "12"},/obj/structure/cable,/obj/machinery/atmospherics/pipe/simple/scrubbers/hidden/layer2,/obj/structure/fans/tiny,/turf/open/floor/plating,/area/ruin/powered)
"xE" = (/obj/structure/cable,/obj/machinery/atmospherics/pipe/simple/scrubbers/hidden/layer2{dir = 6},/turf/open/floor/plasteel/freezer,/area/ruin/powered)
"xZ" = (/obj/structure/urinal{pixel_y = 32},/turf/open/floor/plasteel/freezer,/area/ruin/powered)
"yf" = (/obj/machinery/camera{c_tag = "Dormitory Toilets"; dir = 1},/turf/open/floor/plasteel/freezer,/area/ruin/powered)
"Cw" = (/turf/open/floor/plating{icon_state = "platingdmg1"},/area/ruin/unpowered/no_grav)
"DO" = (/obj/machinery/atmospherics/components/unary/vent_scrubber/on/layer2,/obj/item/flashlight/lantern/heirloom_moth,/turf/open/floor/plasteel/freezer,/area/ruin/powered)
"Ec" = (/obj/structure/lattice,/turf/open/space/basic,/area/ruin/unpowered/no_grav)
"Ex" = (/obj/structure/sign/departments/restroom{pixel_x = 32},/turf/open/floor/plating,/area/ruin/unpowered/no_grav)
"EL" = (/obj/machinery/recharge_station,/obj/machinery/light/small{dir = 1},/obj/machinery/camera{c_tag = "Dormitory Cyborg Recharging Station"},/obj/effect/decal/cleanable/oil,/turf/open/floor/plasteel/freezer,/area/ruin/powered)
"FK" = (/obj/structure/cable,/obj/machinery/atmospherics/pipe/manifold/supply/hidden/layer4{dir = 8},/turf/open/floor/plating{icon_state = "panelscorched"},/area/ruin/unpowered/no_grav)
"FL" = (/obj/structure/toilet{dir = 8},/obj/machinery/light/small{dir = 8},/obj/item/gps/spaceruin,/turf/open/floor/plasteel/freezer,/area/ruin/powered)
"Gy" = (/turf/open/floor/plasteel/freezer,/area/ruin/powered)
"GJ" = (/obj/machinery/shower{dir = 8},/obj/structure/cable,/obj/machinery/atmospherics/pipe/simple/scrubbers/hidden/layer2{dir = 10},/turf/open/floor/plasteel/freezer,/area/ruin/powered)
"GR" = (/obj/structure/cable,/obj/machinery/atmospherics/pipe/manifold/scrubbers/hidden/layer2,/turf/open/floor/plasteel/freezer,/area/ruin/powered)
"Hi" = (/turf/closed/wall,/area/ruin/powered)
"HO" = (/obj/structure/extinguisher_cabinet{pixel_x = -24},/turf/open/floor/plasteel/freezer,/area/ruin/powered)
"Is" = (/obj/structure/cable,/obj/machinery/atmospherics/pipe/simple/supply/hidden/layer4{dir = 4},/obj/machinery/atmospherics/pipe/simple/scrubbers/hidden/layer2{dir = 8},/turf/open/floor/plating,/area/ruin/unpowered/no_grav)
"IB" = (/turf/open/floor/plating{icon_state = "panelscorched"},/area/ruin/unpowered/no_grav)
"JO" = (/obj/structure/cable,/obj/machinery/atmospherics/pipe/simple/scrubbers/hidden/layer2,/turf/open/floor/plasteel/freezer,/area/ruin/powered)
"Mh" = (/turf/template_noop,/area/template_noop)
"Ms" = (/obj/machinery/shower{dir = 4},/obj/item/soap/nanotrasen,/turf/open/floor/plasteel/freezer,/area/ruin/powered)
"MT" = (/obj/structure/sign/departments/restroom{pixel_y = -32},/turf/open/floor/plating{icon_state = "platingdmg2"},/area/ruin/unpowered/no_grav)
"NZ" = (/obj/machinery/light{dir = 1},/obj/machinery/atmospherics/pipe/simple/scrubbers/hidden/layer2{dir = 8},/obj/structure/cable,/turf/open/floor/plasteel/freezer,/area/ruin/powered)
"Oa" = (/obj/structure/cable,/obj/machinery/atmospherics/pipe/simple/scrubbers/hidden/layer2{dir = 5},/turf/open/floor/plating,/area/ruin/unpowered/no_grav)
"Pa" = (/obj/machinery/door/airlock{name = "Unisex Restrooms"},/obj/structure/cable,/obj/machinery/atmospherics/pipe/simple/supply/hidden/layer4{dir = 4},/obj/machinery/atmospherics/pipe/simple/scrubbers/hidden/layer2{dir = 8},/obj/structure/fans/tiny,/turf/open/floor/plasteel/freezer,/area/ruin/powered)
"QL" = (/obj/machinery/shower{dir = 8},/obj/structure/cable,/obj/machinery/atmospherics/pipe/simple/scrubbers/hidden/layer2,/turf/open/floor/plasteel/freezer,/area/ruin/powered)
"WC" = (/obj/structure/toilet{dir = 8},/obj/machinery/light/small{dir = 8},/turf/open/floor/plasteel/freezer,/area/ruin/powered)
"WH" = (/obj/structure/cable,/turf/open/floor/plating{icon_state = "panelscorched"},/area/ruin/unpowered/no_grav)
"XT" = (/obj/machinery/light_switch{pixel_x = -25},/turf/open/floor/plasteel/freezer,/area/ruin/powered)
"Ys" = (/obj/structure/cable,/obj/machinery/atmospherics/pipe/simple/scrubbers/hidden/layer2{dir = 9},/turf/open/floor/plasteel/freezer,/area/ruin/powered)
"Zp" = (/obj/machinery/atmospherics/pipe/simple/supply/hidden/layer4,/turf/open/floor/plating{icon_state = "panelscorched"},/area/ruin/unpowered/no_grav)

(1,1,1) = {"
MhMhMhMhMhMhMhMhMhMhMhMhMhMhMhMhMhMhMhMhMhMh
MhMhMhMhMhMhMhMhMhMhMhMhMhMhMhMhMhMhMhMhMhMh
MhMhMhMhMhMhMhMhMhEcMhMhMhMhMhMhMhMhMhMhMhMh
MhMhMhMhMhMhMhMhMhEcMhMhMhMhMhMhMhMhMhMhMhMh
MhMhMhMhMhMhMhEcMhEcMhMhMhMhMhMhMhMhMhMhMhMh
MhMhMhMhMhMhMhEcIBEcMhMhIBMhMhMhEcMhMhMhMhMh
MhMhMhMhMhMhMhMTIBIBHiHiHiHiHiCwEcMhMhMhMhMh
MhMhMhMhMhMhHiHiwvHiHivIxZruHiIBCwMhMhMhMhMh
MhMhMhMhMhMhHioWGylZHiHODOjmHiHiHiHiHiHiMhMh
MhMhMhMhMhEcHioWmcxEqEqEGRqEsHNZGJHivNMhMhMh
MhMhMhMhMhEcHioWoIJOyfGyGyGyHipeQLHicfMhMhMh
MhMhMhMhEcuxHiHioIpQHikOHikSHiMsQLHiIBIBMhMh
MhMhMhMhwzZpExHioIiHHiFLHiWCHiHiwQHiHiMhMhMh
MhMhEcIBWHFKIsPaumYsHiHiHiHiHiCwOawxjjMhMhMh
MhMhMhEcEcqKIBHiXTGyjrELHiIBIBEcMhMhMhMhMhMh
MhMhMhMhMhwzvNHiHiHiHiHiHiwzEcEcMhMhMhMhMhMh
MhMhMhMhMhEcMhEcEcEcEcEcMhMhEcMhMhMhMhMhMhMh
MhMhMhMhMhMhMhMhEcEcMhMhMhMhEcMhMhMhMhMhMhMh
MhMhMhMhMhMhMhMhMhEcMhMhMhMhMhMhMhMhMhMhMhMh
MhMhMhMhMhMhMhMhMhMhMhMhMhMhMhMhMhMhMhMhMhMh
MhMhMhMhMhMhMhMhMhMhMhMhMhMhMhMhMhMhMhMhMhMh
MhMhMhMhMhMhMhMhMhMhMhMhMhMhMhMhMhMhMhMhMhMh
"}
