//MAP CONVERTED BY dmm2tgm.py THIS HEADER COMMENT PREVENTS RECONVERSION, DO NOT REMOVE
"a" = (
/turf/template_noop,
/area/template_noop)
"b" = (
/obj/item/kirbyplants/random,
/obj/effect/decal/cleanable/dirt,
/obj/effect/decal/cleanable/cobweb,
/turf/open/floor/mineral/plastitanium,
/area/ruin/powered)
"d" = (
/obj/item/kirbyplants/random,
/turf/open/floor/mineral/plastitanium,
/area/ruin/powered)
"e" = (
/obj/machinery/suit_storage_unit/syndicate,
/turf/open/floor/mineral/plastitanium,
/area/ruin/powered)
"f" = (
/obj/structure/window/reinforced/survival_pod,
/obj/structure/table/wood/fancy/black,
/obj/item/pda/syndicate,
/turf/open/floor/mineral/plastitanium,
/area/ruin/powered)
"g" = (
/obj/machinery/door/airlock/vault/derelict,
/turf/open/floor/mineral/plastitanium,
/area/ruin/powered)
"h" = (
/obj/structure/table/reinforced,
/obj/structure/window/reinforced/survival_pod{
	dir = 4
	},
/obj/item/paper_bin/carbon,
/obj/effect/decal/cleanable/cobweb/cobweb2,
/turf/open/floor/mineral/plastitanium,
/area/ruin/powered)
"i" = (
/mob/living/simple_animal/hostile/syndicate/melee/space,
/turf/open/floor/carpet/royalblue,
/area/ruin/powered)
"j" = (
/obj/structure/safe,
/turf/open/floor/mineral/plastitanium,
/area/ruin/powered)
"k" = (
/obj/machinery/door/window/survival_pod{
	dir = 4
	},
/turf/open/floor/mineral/plastitanium,
/area/ruin/powered)
"l" = (
/obj/structure/table/wood/fancy/red,
/obj/item/storage/belt/champion,
/obj/effect/decal/cleanable/cobweb,
/turf/open/floor/mineral/plastitanium,
/area/ruin/powered)
"m" = (
/obj/structure/window/reinforced/survival_pod{
	dir = 1
	},
/obj/structure/table/wood/fancy/black,
/obj/effect/decal/cleanable/dirt,
/obj/item/clothing/suit/space/hardsuit/syndi,
/turf/open/floor/mineral/plastitanium,
/area/ruin/powered)
"n" = (
/obj/structure/table/wood/fancy/red,
/obj/item/fakeartefact,
/obj/effect/decal/cleanable/cobweb/cobweb2,
/turf/open/floor/carpet/royalblack,
/area/ruin/powered)
"q" = (
/obj/effect/decal/cleanable/dirt,
/mob/living/simple_animal/chicken,
/turf/open/floor/carpet/royalblue,
/area/ruin/powered)
"r" = (
/obj/item/kirbyplants/random,
/obj/effect/decal/cleanable/dirt,
/turf/open/floor/mineral/plastitanium,
/area/ruin/powered)
"t" = (
/obj/structure/chair/sofa/corp/left{
	dir = 1
	},
/turf/open/floor/mineral/plastitanium,
/area/ruin/powered)
"u" = (
/obj/structure/chair/sofa/corp/left,
/turf/open/floor/mineral/plastitanium,
/area/ruin/powered)
"v" = (
/obj/structure/window/plasma/reinforced/plastitanium,
/obj/structure/grille,
/obj/effect/decal/cleanable/dirt,
/turf/open/floor/mineral/plastitanium,
/area/ruin/powered)
"x" = (
/obj/effect/decal/cleanable/dirt,
/turf/open/floor/mineral/plastitanium,
/area/ruin/powered)
"z" = (
/obj/structure/chair/comfy/black{
	dir = 4
	},
/obj/effect/decal/cleanable/dirt,
/mob/living/simple_animal/hostile/syndicate/civilian,
/turf/open/floor/mineral/plastitanium,
/area/ruin/powered)
"A" = (
/obj/structure/table/reinforced,
/obj/structure/window/reinforced/survival_pod{
	dir = 4
	},
/obj/item/toy/cards/deck/syndicate,
/turf/open/floor/mineral/plastitanium,
/area/ruin/powered)
"B" = (
/obj/machinery/door/window/survival_pod,
/obj/effect/decal/cleanable/dirt,
/turf/open/floor/mineral/plastitanium,
/area/ruin/powered)
"C" = (
/obj/structure/table/wood/fancy/red,
/obj/item/fakeartefact,
/obj/effect/decal/cleanable/cobweb,
/turf/open/floor/carpet/royalblack,
/area/ruin/powered)
"D" = (
/obj/machinery/light/floor,
/obj/machinery/porta_turret/syndicate/energy,
/turf/open/floor/carpet/royalblack,
/area/ruin/powered)
"E" = (
/obj/structure/table/wood/fancy/red,
/obj/item/gun/ballistic/shotgun/riot,
/turf/open/floor/mineral/plastitanium,
/area/ruin/powered)
"F" = (
/obj/structure/table/wood/fancy/red,
/obj/item/kitchen/knife/combat,
/obj/effect/decal/cleanable/dirt,
/turf/open/floor/mineral/plastitanium,
/area/ruin/powered)
"G" = (
/obj/structure/table/wood/fancy/red,
/obj/item/fakeartefact,
/turf/open/floor/carpet/royalblack,
/area/ruin/powered)
"H" = (
/obj/machinery/door/airlock/vault,
/turf/open/floor/mineral/plastitanium,
/area/ruin/powered)
"I" = (
/obj/structure/window/plasma/reinforced/plastitanium,
/obj/structure/grille,
/turf/open/floor/mineral/plastitanium,
/area/ruin/powered)
"J" = (
/turf/open/floor/mineral/plastitanium,
/area/ruin/powered)
"K" = (
/obj/structure/rack,
/obj/item/book/manual/wiki/toxins,
/obj/item/book/manual/wiki/tcomms,
/turf/open/floor/mineral/plastitanium,
/area/ruin/powered)
"L" = (
/turf/closed/wall/r_wall/syndicate,
/area/ruin/powered)
"M" = (
/obj/structure/rack,
/obj/item/book/manual/wiki/grenades,
/obj/item/book/manual/wiki/barman_recipes,
/turf/open/floor/mineral/plastitanium,
/area/ruin/powered)
"N" = (
/obj/structure/table/wood/fancy/red,
/obj/item/folder/syndicate,
/turf/open/floor/mineral/plastitanium,
/area/ruin/powered)
"O" = (
/obj/machinery/light/floor,
/obj/machinery/porta_turret/syndicate/energy,
/obj/effect/decal/cleanable/dirt,
/turf/open/floor/carpet/royalblack,
/area/ruin/powered)
"P" = (
/obj/structure/table/wood/fancy/black,
/obj/effect/decal/cleanable/dirt,
/obj/item/book/manual/nuclear,
/turf/open/floor/mineral/plastitanium,
/area/ruin/powered)
"Q" = (
/obj/effect/decal/cleanable/dirt,
/turf/open/floor/carpet/royalblue,
/area/ruin/powered)
"R" = (
/obj/structure/chair/sofa/corp/right{
	dir = 1
	},
/turf/open/floor/mineral/plastitanium,
/area/ruin/powered)
"S" = (
/obj/machinery/nuclearbomb/beer,
/obj/machinery/light/floor,
/obj/item/disk/nuclear/fake/obvious,
/turf/open/floor/carpet/royalblue,
/area/ruin/powered)
"U" = (
/obj/effect/decal/cleanable/ash/crematorium,
/obj/effect/decal/remains/human,
/turf/open/floor/mineral/plastitanium,
/area/ruin/powered)
"V" = (
/obj/structure/chair/sofa/corp/right,
/turf/open/floor/mineral/plastitanium,
/area/ruin/powered)
"X" = (
/obj/machinery/door/window/survival_pod{
	dir = 1
	},
/turf/open/floor/mineral/plastitanium,
/area/ruin/powered)
"Y" = (
/turf/open/floor/carpet/royalblue,
/area/ruin/powered)
"Z" = (
/obj/effect/decal/cleanable/dirt,
/obj/effect/decal/cleanable/ash/crematorium,
/obj/effect/decal/remains/human,
/turf/open/floor/mineral/plastitanium,
/area/ruin/powered)

(1,1,1) = {"
a
L
L
L
L
L
L
L
a
"}
(2,1,1) = {"
a
L
l
Y
q
Y
N
L
a
"}
(3,1,1) = {"
a
L
j
Y
S
Y
e
L
a
"}
(4,1,1) = {"
a
L
E
Q
i
Y
F
L
a
"}
(5,1,1) = {"
L
L
L
L
H
L
L
L
L
"}
(6,1,1) = {"
L
b
J
X
J
B
x
d
L
"}
(7,1,1) = {"
L
J
z
m
P
f
z
J
L
"}
(8,1,1) = {"
L
k
A
L
L
L
h
k
L
"}
(9,1,1) = {"
L
x
J
I
C
I
J
x
L
"}
(10,1,1) = {"
L
J
J
I
O
I
J
Z
L
"}
(11,1,1) = {"
L
V
J
I
G
I
J
R
L
"}
(12,1,1) = {"
L
u
x
I
G
I
J
t
L
"}
(13,1,1) = {"
L
K
J
I
D
I
U
M
L
"}
(14,1,1) = {"
L
r
U
I
n
v
J
r
L
"}
(15,1,1) = {"
L
L
g
L
L
L
g
L
L
"}
