//MAP CONVERTED BY dmm2tgm.py THIS HEADER COMMENT PREVENTS RECONVERSION, DO NOT REMOVE
"a" = (
/turf/template_noop,
/area/template_noop)
"e" = (
/turf/open/water,
/area/ruin/has_grav)
"m" = (
/obj/item/melee/halberd{
	anchored = 1
	},
/turf/open/floor/grass/fairy,
/area/ruin/has_grav)
"u" = (
/obj/structure/statue/bone/rib,
/turf/open/floor/grass/fairy,
/area/ruin/has_grav)
"x" = (
/obj/item/melee/rapier{
	anchored = 1
	},
/turf/open/floor/grass/fairy,
/area/ruin/has_grav)
"y" = (
/obj/item/melee/cultblade{
	anchored = 1
	},
/turf/open/floor/grass/fairy,
/area/ruin/has_grav)
"Q" = (
/mob/living/simple_animal/hostile/megafauna/sif,
/turf/open/floor/grass/fairy,
/area/ruin/has_grav)
"S" = (
/turf/closed/indestructible/rock,
/area/ruin/has_grav)
"Y" = (
/turf/open/floor/grass/fairy,
/area/ruin/has_grav)

(1,1,1) = {"
a
a
a
S
S
S
S
S
S
S
S
S
S
S
S
S
S
S
S
S
S
a
a
a
a
"}
(2,1,1) = {"
a
a
S
S
e
e
e
e
e
e
e
e
e
e
e
e
e
e
e
e
S
S
a
a
a
"}
(3,1,1) = {"
a
S
S
e
e
e
e
e
e
e
e
e
e
e
e
e
e
e
e
e
e
S
S
a
a
"}
(4,1,1) = {"
S
S
e
e
e
e
Y
Y
Y
Y
Y
Y
Y
Y
Y
Y
Y
Y
Y
e
e
e
S
S
a
"}
(5,1,1) = {"
S
e
e
e
e
Y
Y
Y
Y
Y
Y
Y
Y
Y
Y
Y
Y
Y
Y
Y
e
e
e
S
S
"}
(6,1,1) = {"
S
e
e
e
Y
Y
Y
Y
Y
Y
Y
Y
Y
Y
Y
Y
Y
Y
Y
Y
Y
e
e
e
S
"}
(7,1,1) = {"
S
e
e
Y
Y
Y
Y
Y
Y
Y
Y
Y
Y
Y
Y
Y
Y
Y
Y
Y
Y
Y
e
e
S
"}
(8,1,1) = {"
S
e
e
Y
Y
Y
Y
Y
Y
Y
Y
Y
Y
Y
Y
Y
Y
Y
Y
Y
Y
Y
Y
e
S
"}
(9,1,1) = {"
S
e
e
Y
Y
Y
Y
Y
Y
Y
Y
Y
Y
Y
Y
Y
Y
Y
Y
Y
Y
Y
Y
e
S
"}
(10,1,1) = {"
S
e
e
Y
Y
Y
Y
Y
Y
Y
Y
Y
Y
Y
Y
Y
Y
Y
Y
Y
Y
Y
Y
e
S
"}
(11,1,1) = {"
S
e
e
Y
Y
Y
Y
Y
Y
Y
Y
Y
Y
Y
Y
Y
Y
Y
Y
Y
Y
Y
Y
e
S
"}
(12,1,1) = {"
S
e
e
Y
Y
Y
Y
Y
Y
m
Y
Y
Y
Y
Y
Y
Y
Y
Y
Y
Y
Y
Y
Y
S
"}
(13,1,1) = {"
S
e
e
Y
Y
Y
Y
Y
Y
Y
u
Y
Y
Q
Y
Y
Y
Y
Y
Y
Y
Y
Y
Y
Y
"}
(14,1,1) = {"
S
e
e
Y
Y
Y
Y
Y
Y
Y
y
Y
Y
Y
Y
Y
Y
Y
Y
Y
Y
Y
Y
Y
S
"}
(15,1,1) = {"
S
e
e
Y
Y
Y
Y
x
Y
Y
Y
Y
Y
Y
Y
Y
Y
Y
Y
Y
Y
Y
Y
e
S
"}
(16,1,1) = {"
S
e
e
Y
Y
Y
Y
Y
Y
Y
Y
Y
Y
Y
Y
Y
Y
Y
Y
Y
Y
Y
Y
e
S
"}
(17,1,1) = {"
S
e
e
Y
Y
Y
Y
Y
Y
Y
Y
Y
Y
Y
Y
Y
Y
Y
Y
Y
Y
Y
Y
e
S
"}
(18,1,1) = {"
S
e
e
Y
Y
Y
Y
Y
Y
Y
Y
Y
Y
Y
Y
Y
Y
Y
Y
Y
Y
Y
Y
e
S
"}
(19,1,1) = {"
S
e
e
Y
Y
Y
Y
Y
Y
Y
Y
Y
Y
Y
Y
Y
Y
Y
Y
Y
Y
Y
e
e
S
"}
(20,1,1) = {"
S
e
e
e
Y
Y
Y
Y
Y
Y
Y
Y
Y
Y
Y
Y
Y
Y
Y
Y
Y
e
e
e
S
"}
(21,1,1) = {"
S
e
e
e
e
Y
Y
Y
Y
Y
Y
Y
Y
Y
Y
Y
Y
Y
Y
Y
e
e
e
S
S
"}
(22,1,1) = {"
S
S
e
e
e
e
Y
Y
Y
Y
Y
Y
Y
Y
Y
Y
Y
Y
Y
e
e
e
S
S
a
"}
(23,1,1) = {"
a
S
S
e
e
e
e
e
e
e
e
e
e
e
e
e
e
e
e
e
e
S
S
a
a
"}
(24,1,1) = {"
a
a
S
S
e
e
e
e
e
e
e
e
e
e
e
e
e
e
e
e
S
S
a
a
a
"}
(25,1,1) = {"
a
a
a
S
S
S
S
S
S
S
S
S
S
S
S
S
S
S
S
S
S
a
a
a
a
"}
