//MAP CONVERTED BY dmm2tgm.py THIS HEADER COMMENT PREVENTS RECONVERSION, DO NOT REMOVE
"a" = (
/turf/template_noop,
/area/template_noop)
"b" = (
/obj/effect/mob_spawn/human/corpse/syndicatesoldier,
/obj/effect/gibspawner/human/bodypartless,
/turf/open/floor/wood,
/area/rockplanet/surface/outdoors)
"d" = (
/obj/structure/filingcabinet/medical,
/turf/open/floor/wood,
/area/rockplanet/surface/outdoors)
"e" = (
/obj/structure/mineral_door/wood,
/turf/open/floor/wood,
/area/rockplanet/surface/outdoors)
"g" = (
/obj/structure/filingcabinet/security,
/turf/open/floor/wood,
/area/rockplanet/surface/outdoors)
"m" = (
/obj/structure/table/wood,
/obj/machinery/recharger,
/turf/open/floor/wood,
/area/rockplanet/surface/outdoors)
"p" = (
/obj/machinery/vending/coffee,
/turf/open/floor/wood,
/area/rockplanet/surface/outdoors)
"y" = (
/obj/machinery/vending/cigarette,
/turf/open/floor/wood,
/area/rockplanet/surface/outdoors)
"z" = (
/obj/structure/filingcabinet/employment,
/turf/open/floor/wood,
/area/rockplanet/surface/outdoors)
"C" = (
/obj/machinery/vending/snack/teal,
/turf/open/floor/wood,
/area/rockplanet/surface/outdoors)
"F" = (
/obj/effect/gibspawner/human/bodypartless,
/turf/open/floor/wood,
/area/rockplanet/surface/outdoors)
"I" = (
/obj/structure/table/wood,
/obj/item/paper_bin,
/turf/open/floor/wood,
/area/rockplanet/surface/outdoors)
"J" = (
/obj/structure/sign/syndicate{
	pixel_x = -32
	},
/obj/effect/mob_spawn/human/corpse/syndicatesoldier,
/obj/effect/gibspawner/human/bodypartless,
/turf/open/floor/wood,
/area/rockplanet/surface/outdoors)
"K" = (
/obj/structure/table/wood,
/turf/open/floor/wood,
/area/rockplanet/surface/outdoors)
"T" = (
/obj/structure/chair/comfy,
/mob/living/simple_animal/hostile/megafauna/claw,
/turf/open/floor/wood,
/area/rockplanet/surface/outdoors)
"V" = (
/turf/open/floor/wood,
/area/rockplanet/surface/outdoors)
"W" = (
/turf/closed/wall/mineral/wood,
/area/rockplanet/surface/outdoors)

(1,1,1) = {"
a
W
W
W
W
W
a
"}
(2,1,1) = {"
W
W
z
m
J
W
W
"}
(3,1,1) = {"
W
d
T
K
V
F
W
"}
(4,1,1) = {"
W
g
b
I
F
V
e
"}
(5,1,1) = {"
W
b
V
V
V
b
W
"}
(6,1,1) = {"
W
W
p
y
C
W
W
"}
(7,1,1) = {"
a
W
W
W
W
W
a
"}
