//MAP CONVERTED BY dmm2tgm.py THIS HEADER COMMENT PREVENTS RECONVERSION, DO NOT REMOVE
"a" = (
/turf/closed/wall/mineral/bronze,
/area/ruin/space/has_grav/powered)
"x" = (
/obj/structure/fluff/clockwork/alloy_shards,
/turf/open/floor/bronze,
/area/ruin/space/has_grav/powered)
"B" = (
/obj/machinery/door/airlock/bronze,
/turf/open/floor/bronze,
/area/ruin/space/has_grav/powered)
"D" = (
/obj/effect/decal/cleanable/dirt/dust,
/mob/living/simple_animal/hostile/megafauna/clockwork_defender,
/turf/open/floor/bronze,
/area/ruin/space/has_grav/powered)
"I" = (
/obj/item/flashlight/lantern,
/turf/open/floor/bronze,
/area/ruin/space/has_grav/powered)
"L" = (
/obj/structure/window/bronze/fulltile,
/obj/structure/grille,
/turf/open/floor/bronze,
/area/ruin/space/has_grav/powered)
"S" = (
/obj/structure/trap/stun,
/turf/open/floor/bronze,
/area/ruin/space/has_grav/powered)
"T" = (
/obj/effect/decal/cleanable/robot_debris/old,
/turf/open/floor/bronze,
/area/ruin/space/has_grav/powered)
"U" = (
/turf/open/floor/bronze,
/area/ruin/space/has_grav/powered)
"X" = (
/obj/structure/fluff/clockwork/clockgolem_remains,
/turf/open/floor/bronze,
/area/ruin/space/has_grav/powered)

(1,1,1) = {"
a
L
L
L
a
"}
(2,1,1) = {"
L
T
U
x
a
"}
(3,1,1) = {"
L
I
D
S
B
"}
(4,1,1) = {"
L
X
U
U
a
"}
(5,1,1) = {"
a
L
L
L
a
"}
