//MAP CONVERTED BY dmm2tgm.py THIS HEADER COMMENT PREVENTS RECONVERSION, DO NOT REMOVE
"a" = (
/turf/closed/mineral/random/stationside/asteroid/rockplanet,
/area/rockplanet/surface/outdoors)
"h" = (
/obj/structure/stone_tile/block{
	dir = 8
	},
/obj/structure/stone_tile/block{
	dir = 4
	},
/mob/living/simple_animal/hostile/megafauna/blood_drunk_miner/hunter,
/turf/open/floor/plating/asteroid/rockplanet,
/area/rockplanet/surface/outdoors)
"i" = (
/obj/structure/stone_tile/cracked,
/obj/structure/stone_tile{
	dir = 8
	},
/obj/structure/stone_tile{
	dir = 1
	},
/turf/open/floor/plating/asteroid/rockplanet,
/area/rockplanet/surface/outdoors)
"j" = (
/obj/structure/stone_tile{
	dir = 4
	},
/obj/structure/stone_tile/cracked,
/obj/structure/stone_tile{
	dir = 8
	},
/turf/open/floor/plating/asteroid/rockplanet,
/area/rockplanet/surface/outdoors)
"l" = (
/obj/structure/stone_tile,
/obj/structure/stone_tile{
	dir = 4
	},
/obj/structure/stone_tile/cracked{
	dir = 8
	},
/turf/open/floor/plating/asteroid/rockplanet,
/area/rockplanet/surface/outdoors)
"o" = (
/obj/structure/stone_tile{
	dir = 8
	},
/obj/structure/stone_tile{
	dir = 1
	},
/obj/structure/stone_tile/cracked,
/turf/open/floor/plating/asteroid/rockplanet,
/area/rockplanet/surface/outdoors)
"u" = (
/obj/structure/stone_tile{
	dir = 4
	},
/obj/structure/stone_tile{
	dir = 8
	},
/obj/structure/stone_tile/cracked,
/turf/open/floor/plating/asteroid/rockplanet,
/area/rockplanet/surface/outdoors)
"x" = (
/obj/structure/stone_tile{
	dir = 1
	},
/obj/structure/stone_tile{
	dir = 8
	},
/obj/structure/stone_tile,
/turf/open/floor/plating/asteroid/rockplanet,
/area/rockplanet/surface/outdoors)
"y" = (
/obj/structure/stone_tile/block/cracked,
/turf/open/floor/plating/asteroid/rockplanet,
/area/rockplanet/surface/outdoors)
"C" = (
/obj/structure/stone_tile/block{
	dir = 8
	},
/obj/structure/stone_tile/block{
	dir = 4
	},
/turf/open/floor/plating/asteroid/rockplanet,
/area/rockplanet/surface/outdoors)
"D" = (
/turf/open/floor/plating/asteroid/rockplanet,
/area/rockplanet/surface/outdoors)
"F" = (
/obj/structure/stone_tile/block{
	dir = 4
	},
/obj/structure/stone_tile/block/cracked{
	dir = 8
	},
/turf/open/floor/plating/asteroid/rockplanet,
/area/rockplanet/surface/outdoors)
"G" = (
/obj/structure/stone_tile/surrounding/cracked{
	dir = 6
	},
/obj/structure/stone_tile/center,
/turf/open/floor/plating/asteroid/rockplanet,
/area/rockplanet/surface/outdoors)
"I" = (
/obj/structure/stone_tile{
	dir = 4
	},
/turf/open/floor/plating/asteroid/rockplanet,
/area/rockplanet/surface/outdoors)
"J" = (
/obj/structure/stone_tile{
	dir = 8
	},
/obj/structure/stone_tile,
/obj/structure/stone_tile/cracked{
	dir = 4
	},
/turf/open/floor/plating/asteroid/rockplanet,
/area/rockplanet/surface/outdoors)
"M" = (
/obj/structure/stone_tile/surrounding_tile/cracked,
/turf/open/floor/plating/asteroid/rockplanet,
/area/rockplanet/surface/outdoors)
"N" = (
/turf/template_noop,
/area/template_noop)
"U" = (
/obj/structure/stone_tile{
	dir = 1
	},
/turf/open/floor/plating/asteroid/rockplanet,
/area/rockplanet/surface/outdoors)
"W" = (
/obj/structure/stone_tile{
	dir = 1
	},
/obj/structure/stone_tile/cracked{
	dir = 8
	},
/obj/structure/stone_tile,
/turf/open/floor/plating/asteroid/rockplanet,
/area/rockplanet/surface/outdoors)
"X" = (
/obj/structure/stone_tile/block{
	dir = 8
	},
/obj/structure/stone_tile/block/cracked{
	dir = 4
	},
/turf/open/floor/plating/asteroid/rockplanet,
/area/rockplanet/surface/outdoors)
"Y" = (
/obj/structure/stone_tile/surrounding_tile{
	dir = 8
	},
/turf/open/floor/plating/asteroid/rockplanet,
/area/rockplanet/surface/outdoors)
"Z" = (
/obj/structure/stone_tile/cracked{
	dir = 4
	},
/turf/open/floor/plating/asteroid/rockplanet,
/area/rockplanet/surface/outdoors)

(1,1,1) = {"
N
N
N
N
N
N
N
N
N
N
N
N
N
N
N
N
"}
(2,1,1) = {"
N
N
N
N
N
N
a
a
a
a
a
a
a
a
a
N
"}
(3,1,1) = {"
N
N
N
a
a
a
a
D
D
D
I
u
D
D
a
N
"}
(4,1,1) = {"
N
a
a
D
D
D
D
D
D
I
i
U
j
D
a
a
"}
(5,1,1) = {"
N
a
D
D
D
D
D
D
I
o
D
D
U
M
D
a
"}
(6,1,1) = {"
N
a
C
X
X
C
F
C
F
X
C
h
F
y
G
a
"}
(7,1,1) = {"
N
a
a
a
D
D
D
D
U
l
D
D
Z
Y
D
a
"}
(8,1,1) = {"
N
N
N
a
a
a
a
a
D
U
J
Z
x
D
a
a
"}
(9,1,1) = {"
N
N
N
N
N
N
N
a
a
D
U
W
a
a
a
N
"}
(10,1,1) = {"
N
N
N
N
N
N
N
N
a
a
a
a
a
N
N
N
"}
(11,1,1) = {"
N
N
N
N
N
N
N
N
N
N
N
N
N
N
N
N
"}
