//MAP CONVERTED BY dmm2tgm.py THIS HEADER COMMENT PREVENTS RECONVERSION, DO NOT REMOVE
"a" = (
/turf/template_noop,
/area/template_noop)
"b" = (
/obj/structure/mineral_door/wood,
/turf/open/floor/wood,
/area/ruin/space/has_grav/powered)
"c" = (
/obj/structure/chair/comfy/black,
/obj/structure/window/reinforced{
	dir = 4
	},
/turf/open/floor/wood,
/area/ruin/space/has_grav/powered)
"e" = (
/mob/living/simple_animal/hostile/megafauna/claw/rockplanet,
/obj/structure/chair/comfy/black,
/obj/structure/fluff/paper/stack{
	dir = 10
	},
/turf/open/floor/wood,
/area/ruin/space/has_grav/powered)
"h" = (
/obj/structure/fluff/paper/corner{
	dir = 4
	},
/obj/structure/fluff/paper/stack{
	dir = 8
	},
/turf/open/floor/wood,
/area/ruin/space/has_grav/powered)
"i" = (
/obj/structure/fluff/paper/stack,
/turf/open/floor/wood,
/area/ruin/space/has_grav/powered)
"j" = (
/obj/structure/reagent_dispensers/water_cooler,
/obj/item/reagent_containers/food/drinks/sillycup,
/obj/item/reagent_containers/food/drinks/sillycup,
/turf/open/floor/wood,
/area/ruin/space/has_grav/powered)
"k" = (
/obj/structure/table/wood,
/obj/item/paper_bin,
/obj/item/pen,
/turf/open/floor/wood,
/area/ruin/space/has_grav/powered)
"q" = (
/turf/open/floor/wood,
/area/ruin/space/has_grav/powered)
"r" = (
/obj/structure/fluff/paper/stack{
	dir = 1
	},
/turf/open/floor/wood,
/area/ruin/space/has_grav/powered)
"s" = (
/obj/structure/chair/comfy/black,
/obj/structure/window/reinforced{
	dir = 4
	},
/obj/effect/mob_spawn/human/corpse/assistant,
/turf/open/floor/wood,
/area/ruin/space/has_grav/powered)
"u" = (
/obj/machinery/light/broken,
/turf/open/floor/wood,
/area/ruin/space/has_grav/powered)
"v" = (
/turf/closed/indestructible/riveted/boss,
/area/ruin/space/has_grav/powered)
"w" = (
/obj/structure/fluff/paper/stack{
	dir = 4
	},
/turf/open/floor/wood,
/area/ruin/space/has_grav/powered)
"x" = (
/obj/structure/fluff/paper/stack{
	dir = 5
	},
/turf/open/floor/wood,
/area/ruin/space/has_grav/powered)
"y" = (
/obj/structure/table,
/obj/structure/window/reinforced,
/obj/machinery/computer{
	dir = 1;
	icon_keyboard = "laptop_key";
	icon_screen = "laptop_broken";
	icon_state = "laptop"
	},
/obj/structure/window/reinforced{
	dir = 8
	},
/obj/machinery/light/broken{
	dir = 4
	},
/turf/open/floor/wood,
/area/ruin/space/has_grav/powered)
"z" = (
/obj/structure/table,
/obj/structure/window/reinforced,
/obj/machinery/computer{
	dir = 1;
	icon_keyboard = "laptop_key";
	icon_screen = "laptop_broken";
	icon_state = "laptop"
	},
/obj/structure/window/reinforced{
	dir = 8
	},
/turf/open/floor/wood,
/area/ruin/space/has_grav/powered)
"D" = (
/obj/structure/fluff/paper/stack{
	dir = 10
	},
/turf/open/floor/wood,
/area/ruin/space/has_grav/powered)
"E" = (
/obj/structure/fluff/paper/corner{
	dir = 4
	},
/obj/structure/filingcabinet/chestdrawer,
/obj/structure/filingcabinet/chestdrawer{
	pixel_x = 16
	},
/turf/open/floor/wood,
/area/ruin/space/has_grav/powered)
"H" = (
/obj/machinery/vending/sovietsoda,
/turf/open/floor/wood,
/area/ruin/space/has_grav/powered)
"I" = (
/obj/structure/table,
/obj/structure/window/reinforced{
	dir = 4
	},
/obj/structure/window/reinforced,
/obj/machinery/computer{
	dir = 1;
	icon_keyboard = "laptop_key";
	icon_screen = "laptop_broken";
	icon_state = "laptop"
	},
/turf/open/floor/wood,
/area/ruin/space/has_grav/powered)
"N" = (
/obj/structure/filingcabinet/filingcabinet{
	pixel_x = -3
	},
/turf/open/floor/wood,
/area/ruin/space/has_grav/powered)
"P" = (
/obj/structure/chair/comfy/black,
/obj/structure/window/reinforced{
	dir = 8
	},
/turf/open/floor/wood,
/area/ruin/space/has_grav/powered)
"Q" = (
/obj/machinery/light/broken{
	dir = 8
	},
/turf/open/floor/wood,
/area/ruin/space/has_grav/powered)
"U" = (
/obj/machinery/light/broken{
	dir = 1
	},
/turf/open/floor/wood,
/area/ruin/space/has_grav/powered)
"V" = (
/obj/structure/fluff/paper{
	dir = 9
	},
/obj/structure/filingcabinet/filingcabinet{
	pixel_x = 3
	},
/obj/structure/filingcabinet/chestdrawer{
	pixel_x = 16
	},
/obj/machinery/light/broken{
	dir = 1
	},
/turf/open/floor/wood,
/area/ruin/space/has_grav/powered)
"W" = (
/obj/structure/chair/comfy/black,
/obj/effect/mob_spawn/human/corpse/assistant,
/obj/structure/window/reinforced{
	dir = 8
	},
/turf/open/floor/wood,
/area/ruin/space/has_grav/powered)
"Y" = (
/obj/structure/table/wood,
/turf/open/floor/wood,
/area/ruin/space/has_grav/powered)
"Z" = (
/obj/effect/mob_spawn/human/corpse/assistant,
/turf/open/floor/wood,
/area/ruin/space/has_grav/powered)

(1,1,1) = {"
v
v
v
v
v
v
v
v
v
v
a
"}
(2,1,1) = {"
v
V
h
k
q
Q
w
s
I
v
v
"}
(3,1,1) = {"
v
E
w
Y
x
q
q
c
I
u
v
"}
(4,1,1) = {"
v
N
e
Y
q
w
q
c
I
q
v
"}
(5,1,1) = {"
v
q
q
Y
w
Z
q
c
I
q
v
"}
(6,1,1) = {"
v
U
Z
q
q
q
D
q
q
q
b
"}
(7,1,1) = {"
v
i
i
q
P
z
q
P
z
q
v
"}
(8,1,1) = {"
v
H
q
q
W
z
q
P
z
q
v
"}
(9,1,1) = {"
v
j
r
Z
P
z
q
W
z
u
v
"}
(10,1,1) = {"
v
U
q
x
P
y
q
P
z
v
v
"}
(11,1,1) = {"
v
v
v
v
v
v
v
v
v
v
a
"}
