//MAP CONVERTED BY dmm2tgm.py THIS HEADER COMMENT PREVENTS RECONVERSION, DO NOT REMOVE
"aw" = (
/obj/structure/punji_sticks/spikes,
/turf/open/floor/plating/asteroid,
/area/space)
"cm" = (
/obj/vehicle/ridden/atv,
/turf/open/floor/plating/asteroid,
/area/space)
"dp" = (
/obj/effect/decal/cleanable/ash,
/turf/open/floor/plating/asteroid,
/area/space)
"eP" = (
/obj/machinery/door/airlock/grunge,
/obj/effect/decal/cleanable/dirt,
/turf/open/floor/plating,
/area/space)
"gM" = (
/obj/structure/fence/corner,
/turf/open/floor/plating/asteroid,
/area/space)
"is" = (
/obj/structure/fence{
	dir = 4
	},
/turf/open/floor/plating/asteroid,
/area/space)
"iw" = (
/obj/effect/decal/cleanable/oil,
/turf/open/floor/plating/rust,
/area/space)
"jY" = (
/obj/structure/rack,
/obj/item/weldingtool/hugetank,
/obj/item/shovel,
/obj/effect/decal/cleanable/dirt,
/turf/open/floor/plating/rust,
/area/space)
"kg" = (
/obj/effect/spawner/structure/window,
/obj/structure/barricade/wooden/crude,
/obj/effect/decal/cleanable/glass,
/turf/open/floor/plating,
/area/space)
"lm" = (
/obj/structure/fence/corner{
	dir = 10
	},
/turf/open/floor/plating/asteroid,
/area/space)
"mB" = (
/obj/structure/table/wood/fancy/red,
/obj/item/reagent_containers/food/drinks/bottle/vodka,
/turf/open/floor/plating/rust,
/area/space)
"ne" = (
/obj/effect/decal/cleanable/dirt,
/turf/open/floor/plating,
/area/space)
"nE" = (
/obj/machinery/power/port_gen/pacman,
/obj/structure/cable,
/obj/effect/decal/cleanable/dirt,
/turf/open/floor/plating/rust,
/area/space)
"nP" = (
/turf/closed/wall,
/area/space)
"op" = (
/obj/structure/sink/oil_well,
/turf/open/floor/plating/asteroid,
/area/space)
"pr" = (
/turf/template_noop,
/area/template_noop)
"rJ" = (
/obj/structure/reagent_dispensers/fueltank,
/obj/effect/decal/cleanable/oil,
/turf/open/floor/plating/rust,
/area/space)
"rW" = (
/obj/structure/rack,
/obj/item/construction/plumbing,
/turf/open/floor/plating/asteroid,
/area/space)
"sf" = (
/obj/structure/closet/gimmick/russian,
/turf/open/floor/plating/rust,
/area/space)
"sr" = (
/obj/structure/cable,
/obj/effect/decal/cleanable/wrapping,
/obj/effect/decal/cleanable/dirt,
/turf/open/floor/plating/rust,
/area/space)
"sV" = (
/obj/structure/table,
/obj/item/gun/ballistic/revolver/russian,
/turf/open/floor/plating/rust,
/area/space)
"tl" = (
/obj/structure/fence{
	dir = 8
	},
/turf/open/floor/plating/asteroid,
/area/space)
"ut" = (
/obj/structure/rack,
/obj/item/clothing/head/welding,
/obj/item/clothing/head/welding,
/obj/structure/cable,
/obj/item/storage/belt/utility/full,
/turf/open/floor/plating/rust,
/area/space)
"uG" = (
/obj/structure/rack,
/obj/item/stack/ducts/fifty,
/obj/item/stack/sheet/mineral/plasma,
/obj/item/stack/sheet/mineral/plasma,
/obj/item/stack/sheet/mineral/plasma,
/obj/item/stack/sheet/mineral/plasma,
/obj/item/stack/sheet/mineral/plasma,
/obj/item/stack/sheet/mineral/plasma,
/obj/item/stack/sheet/mineral/plasma,
/obj/item/stack/sheet/mineral/plasma,
/obj/item/stack/sheet/mineral/plasma,
/obj/item/stack/sheet/mineral/plasma,
/obj/item/stack/sheet/mineral/plasma,
/turf/open/floor/plating,
/area/space)
"vt" = (
/obj/structure/rack,
/obj/item/weldingtool,
/obj/item/key/atv,
/obj/item/book/granter/language_book/russian,
/turf/open/floor/plating,
/area/space)
"vx" = (
/obj/structure/fence/door/opened,
/obj/effect/mine/stun,
/turf/open/floor/plating/asteroid,
/area/space)
"vM" = (
/obj/structure/sign/poster/contraband/rebels_unite,
/turf/closed/wall,
/area/space)
"wm" = (
/obj/structure/ore_box,
/obj/effect/decal/cleanable/cobweb,
/obj/effect/decal/cleanable/oil,
/obj/effect/decal/cleanable/dirt,
/turf/open/floor/plating/rust,
/area/space)
"xs" = (
/obj/item/wallframe/extinguisher_cabinet,
/turf/closed/wall,
/area/space)
"xN" = (
/turf/open/floor/plating/asteroid,
/area/space)
"yY" = (
/obj/machinery/door/airlock/grunge,
/turf/open/floor/plating,
/area/space)
"zb" = (
/obj/effect/spawner/structure/window,
/obj/structure/barricade/wooden/crude,
/turf/open/floor/plating,
/area/space)
"ze" = (
/obj/effect/decal/cleanable/glass,
/obj/structure/punji_sticks/spikes,
/turf/open/floor/plating/asteroid,
/area/space)
"zg" = (
/obj/effect/decal/cleanable/robot_debris,
/turf/open/floor/plating/asteroid,
/area/space)
"BG" = (
/turf/closed/wall/rust,
/area/space)
"Dj" = (
/obj/structure/sign/poster/contraband/communist_state,
/turf/closed/wall,
/area/space)
"DO" = (
/obj/structure/sign/departments/engineering,
/turf/closed/wall/rust,
/area/space)
"Fg" = (
/obj/structure/chair/comfy/beige,
/mob/living/simple_animal/hostile/russian,
/turf/open/floor/plating,
/area/space)
"FY" = (
/obj/structure/table,
/obj/item/flashlight/lamp/green,
/obj/item/radio,
/turf/open/floor/plating/rust,
/area/space)
"GW" = (
/turf/open/floor/plating/rust,
/area/space)
"If" = (
/obj/structure/rack,
/obj/item/clothing/glasses/welding,
/obj/item/clothing/glasses/welding,
/obj/item/trash/syndi_cakes,
/turf/open/floor/plating,
/area/space)
"IB" = (
/obj/machinery/plumbing/liquid_pump,
/turf/open/floor/plating/asteroid,
/area/space)
"Mn" = (
/obj/structure/rack,
/obj/item/weldingtool/largetank,
/obj/item/key/atv,
/obj/effect/decal/cleanable/cobweb/cobweb2,
/turf/open/floor/plating/rust,
/area/space)
"MJ" = (
/mob/living/simple_animal/hostile/bear/russian,
/turf/open/floor/plating,
/area/space)
"Ob" = (
/obj/effect/decal/cleanable/wrapping,
/obj/effect/decal/cleanable/dirt,
/mob/living/simple_animal/hostile/russian,
/turf/open/floor/plating/rust,
/area/space)
"OR" = (
/obj/machinery/vending/sovietsoda,
/obj/structure/cable,
/turf/open/floor/plating/rust,
/area/space)
"Pg" = (
/obj/structure/table,
/obj/item/paper_bin,
/obj/item/pen/fountain,
/obj/effect/decal/cleanable/glass,
/turf/open/floor/plating/rust,
/area/space)
"PI" = (
/obj/structure/sign/poster/contraband/revolver,
/turf/closed/wall/rust,
/area/space)
"Qv" = (
/obj/structure/fence,
/turf/open/floor/plating/asteroid,
/area/space)
"QX" = (
/obj/structure/cable,
/turf/open/floor/plating/rust,
/area/space)
"VO" = (
/obj/effect/decal/cleanable/oil,
/turf/open/floor/plating/asteroid,
/area/space)
"VS" = (
/obj/structure/closet/crate/trashcart,
/turf/open/floor/plating/rust,
/area/space)
"WB" = (
/obj/structure/ore_box,
/turf/open/floor/plating/rust,
/area/space)
"WO" = (
/turf/open/floor/plating,
/area/space)

(1,1,1) = {"
pr
pr
pr
aw
ze
aw
pr
pr
dp
pr
pr
pr
"}
(2,1,1) = {"
pr
nP
nP
nP
zb
BG
BG
BG
Qv
Qv
lm
pr
"}
(3,1,1) = {"
dp
nP
wm
Ob
QX
QX
nE
BG
cm
xN
is
pr
"}
(4,1,1) = {"
dp
BG
WB
sr
ut
GW
rJ
Dj
cm
xN
vx
pr
"}
(5,1,1) = {"
pr
PI
mB
QX
If
ne
VS
nP
zg
xN
tl
pr
"}
(6,1,1) = {"
pr
BG
OR
QX
uG
ne
ne
yY
xN
xN
is
pr
"}
(7,1,1) = {"
aw
xs
iw
WO
ne
WO
WO
eP
xN
xN
tl
dp
"}
(8,1,1) = {"
ze
zb
ne
MJ
WO
WO
FY
nP
IB
xN
tl
pr
"}
(9,1,1) = {"
aw
zb
GW
WO
ne
Fg
sV
DO
op
xN
vx
pr
"}
(10,1,1) = {"
aw
vM
Mn
jY
vt
sf
Pg
BG
rW
VO
tl
pr
"}
(11,1,1) = {"
pr
BG
BG
nP
nP
kg
zb
nP
Qv
Qv
gM
pr
"}
(12,1,1) = {"
pr
pr
pr
pr
aw
aw
aw
aw
pr
pr
pr
pr
"}
