//MAP CONVERTED BY dmm2tgm.py THIS HEADER COMMENT PREVENTS RECONVERSION, DO NOT REMOVE
"a" = (
/turf/closed/indestructible/riveted/hierophant,
/area/ruin/unpowered/hierophant)
"d" = (
/mob/living/simple_animal/hostile/megafauna/hierophant,
/turf/open/floor/plating/rust,
/area/ruin/unpowered/hierophant)
"m" = (
/turf/template_noop,
/area/template_noop)
"K" = (
/obj/effect/light_emitter{
	set_cap = 3;
	set_luminosity = 5
	},
/turf/open/floor/plating/rust,
/area/ruin/unpowered/hierophant)
"N" = (
/turf/closed/wall/r_wall/rust,
/area/ruin/unpowered/hierophant)
"X" = (
/turf/open/floor/plating/rust,
/area/ruin/unpowered/hierophant)
"Z" = (
/turf/closed/wall/rust,
/area/ruin/unpowered/hierophant)

(1,1,1) = {"
m
m
m
X
X
X
X
a
a
N
N
a
a
a
a
a
X
X
X
X
N
N
N
"}
(2,1,1) = {"
m
m
X
X
X
X
X
X
X
X
X
K
X
X
X
X
X
X
X
X
X
X
N
"}
(3,1,1) = {"
m
m
X
X
K
K
X
X
X
a
X
X
X
a
X
X
X
K
K
X
X
X
N
"}
(4,1,1) = {"
m
m
X
X
X
X
X
X
X
X
X
X
X
X
X
X
X
X
X
X
X
X
X
"}
(5,1,1) = {"
m
X
X
X
N
a
X
X
X
X
X
K
X
X
X
K
X
a
a
X
K
X
X
"}
(6,1,1) = {"
m
X
X
X
N
a
X
K
X
X
X
K
X
X
X
K
X
a
a
X
K
X
X
"}
(7,1,1) = {"
m
X
X
X
X
X
X
X
X
X
X
X
X
X
X
X
X
X
X
X
X
X
X
"}
(8,1,1) = {"
m
X
X
X
K
K
X
X
X
a
X
X
X
a
X
X
X
K
K
X
X
X
N
"}
(9,1,1) = {"
N
X
X
X
X
X
X
X
X
X
X
K
X
X
X
X
X
X
X
X
X
X
a
"}
(10,1,1) = {"
N
X
N
X
X
X
X
N
X
X
X
X
X
X
X
a
X
X
X
X
a
X
a
"}
(11,1,1) = {"
N
X
X
X
X
X
X
X
X
X
X
X
X
X
X
X
X
X
X
X
X
X
m
"}
(12,1,1) = {"
N
K
X
X
X
K
X
X
K
X
X
d
X
X
K
X
X
K
K
X
X
X
m
"}
(13,1,1) = {"
N
X
X
X
X
X
X
X
X
X
X
X
X
X
X
X
X
X
X
X
X
X
m
"}
(14,1,1) = {"
N
X
Z
X
X
X
X
a
X
X
X
X
X
X
X
a
X
X
X
X
N
X
m
"}
(15,1,1) = {"
N
X
X
X
X
X
X
X
X
X
X
K
X
X
X
X
X
X
X
X
X
X
m
"}
(16,1,1) = {"
a
X
X
X
K
K
X
X
X
a
X
X
X
a
X
X
X
K
K
X
X
X
m
"}
(17,1,1) = {"
X
X
X
X
X
X
X
X
X
X
X
X
X
X
X
X
X
X
X
X
X
X
m
"}
(18,1,1) = {"
X
X
K
X
a
a
X
K
X
X
X
K
X
X
X
K
X
a
a
X
K
X
m
"}
(19,1,1) = {"
X
X
K
X
a
Z
X
K
X
X
X
K
X
X
X
K
X
a
a
X
K
X
X
"}
(20,1,1) = {"
X
X
X
X
X
X
X
X
X
X
X
X
X
X
X
X
X
X
X
X
X
X
X
"}
(21,1,1) = {"
N
X
X
X
K
K
X
X
X
a
X
X
X
a
X
X
X
K
K
X
X
X
a
"}
(22,1,1) = {"
N
X
X
X
X
X
X
X
X
X
X
K
X
X
X
X
X
X
X
X
X
X
a
"}
(23,1,1) = {"
a
a
N
X
X
X
X
a
a
a
a
a
a
a
a
a
X
X
X
X
a
a
a
"}
