//MAP CONVERTED BY dmm2tgm.py THIS HEADER COMMENT PREVENTS RECONVERSION, DO NOT REMOVE
"d" = (
/mob/living/simple_animal/hostile/megafauna/hierophant/rockplanet,
/turf/open/floor/plating/rust,
/area/ruin/unpowered/hierophant)
"j" = (
/turf/open/floor/plating,
/area/ruin/unpowered/hierophant)
"m" = (
/turf/template_noop,
/area/template_noop)
"F" = (
/obj/effect/light_emitter{
	set_cap = 3;
	set_luminosity = 5
	},
/turf/open/floor/plating,
/area/ruin/unpowered/hierophant)
"K" = (
/obj/effect/light_emitter{
	set_cap = 3;
	set_luminosity = 5
	},
/turf/open/floor/plating/rust,
/area/ruin/unpowered/hierophant)
"N" = (
/turf/closed/wall/r_wall/rust,
/area/ruin/unpowered/hierophant)
"X" = (
/turf/open/floor/plating/rust,
/area/ruin/unpowered/hierophant)

(1,1,1) = {"
m
m
m
j
j
j
j
N
N
N
N
N
N
N
N
N
j
j
j
j
N
N
N
"}
(2,1,1) = {"
m
m
j
j
j
j
j
j
j
j
j
F
j
j
j
j
j
j
j
j
j
j
N
"}
(3,1,1) = {"
m
m
j
j
F
F
j
j
j
N
j
j
j
N
j
j
j
F
F
j
j
j
N
"}
(4,1,1) = {"
m
m
j
j
j
j
j
j
j
j
j
j
j
j
j
j
X
j
j
j
j
j
X
"}
(5,1,1) = {"
m
X
X
X
N
N
X
X
j
j
j
F
j
j
j
F
X
N
N
X
F
j
j
"}
(6,1,1) = {"
m
X
X
X
N
N
X
K
X
j
j
F
j
j
j
F
X
N
N
j
F
j
j
"}
(7,1,1) = {"
m
X
X
X
X
X
X
X
X
j
j
j
j
j
j
j
j
X
X
j
j
j
j
"}
(8,1,1) = {"
m
X
X
X
K
K
X
X
X
N
X
X
X
N
X
j
j
F
F
j
j
j
N
"}
(9,1,1) = {"
N
X
X
X
X
X
X
X
X
X
X
K
X
X
X
j
j
j
j
j
j
j
N
"}
(10,1,1) = {"
N
X
N
X
X
X
X
N
X
X
X
X
X
X
X
N
j
j
j
j
N
j
N
"}
(11,1,1) = {"
N
X
X
X
X
X
X
X
X
X
X
X
X
X
X
X
X
j
j
j
j
j
m
"}
(12,1,1) = {"
N
K
X
X
X
K
X
X
K
X
X
d
X
X
K
X
X
F
F
j
j
j
m
"}
(13,1,1) = {"
N
X
X
X
X
X
X
X
X
X
X
X
X
X
X
X
X
j
j
j
j
j
m
"}
(14,1,1) = {"
N
X
N
X
X
X
X
N
X
X
X
X
X
X
X
N
X
j
j
j
N
j
m
"}
(15,1,1) = {"
N
X
X
X
X
X
X
X
X
X
X
K
X
X
X
X
X
j
j
j
j
j
m
"}
(16,1,1) = {"
N
X
X
X
K
K
X
X
X
N
X
X
X
N
X
X
X
F
F
j
j
j
m
"}
(17,1,1) = {"
j
X
X
X
X
X
X
X
X
X
X
X
X
X
X
X
X
X
j
j
j
j
m
"}
(18,1,1) = {"
j
X
K
X
N
N
X
K
X
X
X
K
X
X
X
K
X
N
N
j
F
j
m
"}
(19,1,1) = {"
j
X
K
X
N
N
X
K
X
X
X
K
X
X
X
K
X
N
N
j
F
j
j
"}
(20,1,1) = {"
j
j
X
X
X
X
X
X
X
X
X
X
X
X
X
X
X
X
X
X
X
j
j
"}
(21,1,1) = {"
N
j
X
X
K
K
X
X
X
N
X
X
X
N
X
X
X
K
K
X
X
j
N
"}
(22,1,1) = {"
N
j
j
j
X
X
X
X
X
X
X
K
X
X
X
X
X
X
X
X
X
j
N
"}
(23,1,1) = {"
N
N
N
j
j
j
j
N
N
N
N
N
N
N
N
N
X
X
X
X
X
N
N
"}
