//MAP CONVERTED BY dmm2tgm.py THIS HEADER COMMENT PREVENTS RECONVERSION, DO NOT REMOVE
"a" = (
/turf/closed/wall/mineral/silver,
/area/ruin/has_grav)
"o" = (
/turf/template_noop,
/area/template_noop)
"r" = (
/obj/effect/light_emitter,
/mob/living/simple_animal/hostile/platinum,
/turf/open/floor/mineral/titanium,
/area/ruin/has_grav)
"F" = (
/obj/structure/mineral_door/silver,
/turf/open/floor/mineral/titanium,
/area/ruin/has_grav)
"J" = (
/turf/open/floor/mineral/titanium,
/area/ruin/has_grav)
"Q" = (
/obj/effect/light_emitter,
/turf/open/floor/mineral/titanium,
/area/ruin/has_grav)

(1,1,1) = {"
a
a
o
o
o
o
o
o
o
o
o
o
o
a
a
"}
(2,1,1) = {"
a
o
o
o
o
o
o
o
o
o
o
o
o
o
a
"}
(3,1,1) = {"
o
o
a
a
a
F
a
a
a
F
a
a
a
o
o
"}
(4,1,1) = {"
o
o
a
J
J
J
J
J
J
J
J
J
a
o
o
"}
(5,1,1) = {"
o
o
a
J
Q
J
J
J
J
J
Q
J
a
o
o
"}
(6,1,1) = {"
o
o
F
J
J
a
a
F
a
a
J
J
F
o
o
"}
(7,1,1) = {"
o
o
a
J
J
a
J
J
J
a
J
J
a
o
o
"}
(8,1,1) = {"
o
o
a
J
J
F
J
r
J
F
J
J
a
o
o
"}
(9,1,1) = {"
o
o
a
J
J
a
J
J
J
a
J
J
a
o
o
"}
(10,1,1) = {"
o
o
F
J
J
a
a
F
a
a
J
J
F
o
o
"}
(11,1,1) = {"
o
o
a
J
Q
J
J
J
J
J
Q
J
a
o
o
"}
(12,1,1) = {"
o
o
a
J
J
J
J
J
J
J
J
J
a
o
o
"}
(13,1,1) = {"
o
o
a
a
a
F
a
a
a
F
a
a
a
o
o
"}
(14,1,1) = {"
a
o
o
o
o
o
o
o
o
o
o
o
o
o
a
"}
(15,1,1) = {"
a
a
o
o
o
o
o
o
o
o
o
o
o
a
a
"}
