//MAP CONVERTED BY dmm2tgm.py THIS HEADER COMMENT PREVENTS RECONVERSION, DO NOT REMOVE
"a" = (
/turf/template_noop,
/area/template_noop)
"h" = (
/turf/closed/wall/mineral/silver,
/area/rockplanet/surface/outdoors)
"i" = (
/obj/effect/decal/remains/human,
/turf/open/floor/carpet/red,
/area/rockplanet/surface/outdoors)
"o" = (
/obj/structure/mineral_door/silver,
/turf/open/floor/carpet/red,
/area/rockplanet/surface/outdoors)
"p" = (
/obj/item/stack/sheet/mineral/gold/twenty,
/turf/open/floor/carpet/red,
/area/rockplanet/surface/outdoors)
"t" = (
/obj/effect/decal/remains/human,
/obj/effect/turf_decal/sand,
/turf/open/floor/carpet/red,
/area/rockplanet/surface/outdoors)
"w" = (
/turf/open/floor/carpet/red,
/area/rockplanet/surface/outdoors)
"G" = (
/obj/effect/turf_decal/sand,
/turf/open/floor/carpet/red,
/area/rockplanet/surface/outdoors)
"K" = (
/mob/living/simple_animal/hostile/megafauna/praetor,
/obj/structure/chair/bronze{
	name = "gold chair"
	},
/obj/effect/light_emitter,
/turf/open/floor/carpet/red,
/area/rockplanet/surface/outdoors)
"R" = (
/obj/effect/turf_decal/sand,
/obj/effect/decal/remains/human,
/turf/open/floor/carpet/red,
/area/rockplanet/surface/outdoors)
"W" = (
/obj/item/stack/sheet/mineral/gold,
/turf/open/floor/carpet/red,
/area/rockplanet/surface/outdoors)
"Y" = (
/obj/structure/statue/sandstone/venus,
/turf/open/floor/carpet/red,
/area/rockplanet/surface/outdoors)

(1,1,1) = {"
h
h
h
h
h
h
h
a
a
a
a
a
"}
(2,1,1) = {"
h
i
p
w
W
w
h
h
a
a
a
a
"}
(3,1,1) = {"
h
p
p
p
w
i
w
h
Y
a
a
a
"}
(4,1,1) = {"
h
Y
w
w
W
w
w
o
i
G
a
i
"}
(5,1,1) = {"
h
w
K
w
w
W
w
h
G
R
G
w
"}
(6,1,1) = {"
h
Y
w
w
W
w
w
o
t
G
i
a
"}
(7,1,1) = {"
h
w
W
i
w
w
i
h
Y
a
a
a
"}
(8,1,1) = {"
h
w
w
w
W
w
h
h
a
a
a
a
"}
(9,1,1) = {"
h
h
h
h
h
h
h
a
a
a
a
a
"}
