//MAP CONVERTED BY dmm2tgm.py THIS HEADER COMMENT PREVENTS RECONVERSION, DO NOT REMOVE
"aB" = (
/obj/effect/turf_decal/tile/red,
/obj/effect/turf_decal/tile/red{
	dir = 8
	},
/obj/structure/rack,
/obj/item/storage/toolbox/emergency,
/obj/item/weldingtool,
/obj/effect/turf_decal/tile/red{
	dir = 4
	},
/turf/open/floor/plasteel/dark,
/area/shuttle/syndicate/bridge)
"aJ" = (
/obj/machinery/atmospherics/pipe/simple/supply/hidden{
	dir = 4
	},
/obj/effect/turf_decal/tile/red,
/obj/effect/turf_decal/tile/red{
	dir = 8
	},
/turf/open/floor/plasteel/dark,
/area/shuttle/syndicate/eva)
"cu" = (
/obj/machinery/porta_turret/syndicate{
	dir = 9
	},
/turf/closed/wall/mineral/plastitanium,
/area/shuttle/syndicate)
"dn" = (
/obj/machinery/button/door{
	id = "syndicatecutter_bolt_port";
	name = "External Bolt Control";
	normaldoorcontrol = 1;
	pixel_x = -4;
	pixel_y = 25;
	req_access_txt = "150";
	specialfunctions = 4
	},
/obj/machinery/atmospherics/pipe/simple/supply/hidden{
	dir = 4
	},
/turf/open/floor/plasteel/dark/side,
/area/shuttle/syndicate/medical)
"dX" = (
/obj/effect/turf_decal/tile/neutral{
	dir = 1
	},
/obj/effect/turf_decal/tile/neutral,
/obj/effect/turf_decal/tile/neutral{
	dir = 4
	},
/obj/effect/turf_decal/tile/neutral{
	dir = 8
	},
/obj/structure/chair/comfy/shuttle{
	dir = 1
	},
/turf/open/floor/plasteel/dark,
/area/shuttle/syndicate/bridge)
"eb" = (
/obj/machinery/porta_turret/syndicate{
	dir = 6
	},
/turf/closed/wall/mineral/plastitanium/nodiagonal,
/area/shuttle/syndicate/bridge)
"ev" = (
/obj/machinery/power/smes{
	charge = 5e+006
	},
/obj/effect/turf_decal/stripes/line{
	dir = 5
	},
/obj/structure/cable{
	icon_state = "0-4"
	},
/turf/open/floor/plating,
/area/shuttle/syndicate)
"eF" = (
/obj/machinery/airalarm{
	dir = 4;
	icon_state = "alarm0";
	pixel_x = -24;
	req_access = list(150)
	},
/turf/open/floor/plasteel/dark,
/area/shuttle/syndicate/bridge)
"eM" = (
/obj/machinery/atmospherics/pipe/simple/supply/hidden{
	dir = 4
	},
/turf/open/floor/plasteel/dark,
/area/shuttle/syndicate/bridge)
"eQ" = (
/obj/machinery/light/small{
	dir = 4
	},
/obj/machinery/atmospherics/pipe/simple/supply/hidden,
/turf/open/floor/plating,
/area/shuttle/syndicate)
"fJ" = (
/obj/machinery/atmospherics/pipe/manifold/supply/hidden{
	dir = 4
	},
/obj/effect/turf_decal/tile/neutral{
	dir = 1
	},
/obj/effect/turf_decal/tile/neutral,
/obj/effect/turf_decal/tile/neutral{
	dir = 4
	},
/obj/effect/turf_decal/tile/neutral{
	dir = 8
	},
/turf/open/floor/plasteel/dark,
/area/shuttle/syndicate/armory)
"gf" = (
/obj/structure/chair{
	dir = 8;
	name = "tactical chair"
	},
/turf/open/floor/plasteel/dark,
/area/shuttle/syndicate)
"gI" = (
/obj/machinery/light/small{
	dir = 4
	},
/turf/open/floor/plasteel/dark,
/area/shuttle/syndicate/eva)
"gL" = (
/obj/structure/table,
/obj/effect/turf_decal/stripes/line,
/obj/item/storage/box/handcuffs,
/turf/open/floor/mineral/plastitanium,
/area/shuttle/syndicate/eva)
"gR" = (
/obj/machinery/computer/crew/syndie,
/turf/open/floor/plasteel/dark,
/area/shuttle/syndicate/bridge)
"gX" = (
/turf/open/floor/plasteel/dark,
/area/shuttle/syndicate/armory)
"hi" = (
/obj/machinery/power/apc{
	dir = 8;
	name = "Syndicate Cutter APC";
	pixel_x = -25;
	req_access = 150
	},
/obj/machinery/atmospherics/pipe/simple/supply/hidden,
/obj/machinery/airalarm{
	dir = 8;
	icon_state = "alarm0";
	pixel_x = 24;
	req_access = 150
	},
/obj/structure/cable{
	icon_state = "0-2"
	},
/turf/open/floor/plating,
/area/shuttle/syndicate)
"hu" = (
/obj/structure/table/reinforced,
/obj/item/ammo_box/magazine/m10mm{
	pixel_x = -3;
	pixel_y = 3
	},
/obj/item/ammo_box/magazine/m10mm,
/turf/open/floor/plasteel/dark,
/area/shuttle/syndicate/armory)
"il" = (
/obj/machinery/atmospherics/pipe/manifold/supply/hidden{
	dir = 8
	},
/obj/machinery/meter,
/turf/open/floor/plating,
/area/shuttle/syndicate)
"iq" = (
/obj/machinery/porta_turret/syndicate{
	dir = 10
	},
/turf/closed/wall/mineral/plastitanium,
/area/shuttle/syndicate)
"iu" = (
/obj/machinery/porta_turret/syndicate{
	dir = 6
	},
/turf/closed/wall/mineral/plastitanium,
/area/shuttle/syndicate/armory)
"iD" = (
/obj/machinery/atmospherics/pipe/simple/supply/hidden{
	dir = 4
	},
/turf/open/floor/plasteel/dark/side{
	dir = 4
	},
/area/shuttle/syndicate/armory)
"iI" = (
/obj/structure/chair{
	dir = 4;
	name = "tactical chair"
	},
/obj/machinery/airalarm{
	dir = 4;
	icon_state = "alarm0";
	pixel_x = -24;
	req_access = list(150)
	},
/obj/effect/turf_decal/tile/red{
	dir = 8
	},
/turf/open/floor/plasteel/dark,
/area/shuttle/syndicate/armory)
"iQ" = (
/obj/structure/shuttle/engine/propulsion/burst/left{
	dir = 8
	},
/turf/open/floor/plating/airless,
/area/shuttle/syndicate)
"jp" = (
/turf/open/floor/plasteel/dark,
/area/shuttle/syndicate/bridge)
"jv" = (
/obj/structure/sign/departments/medbay/alt,
/turf/closed/wall/mineral/plastitanium/nodiagonal,
/area/shuttle/syndicate/medical)
"jG" = (
/obj/machinery/atmospherics/pipe/simple/supply/hidden{
	dir = 4
	},
/obj/machinery/door/airlock/security/glass{
	name = "Equipment Room";
	req_access_txt = "150"
	},
/obj/machinery/door/firedoor/border_only{
	dir = 4
	},
/obj/machinery/door/firedoor/border_only{
	dir = 8
	},
/obj/machinery/atmospherics/pipe/simple/supply/hidden{
	dir = 4
	},
/turf/open/floor/plasteel/dark,
/area/shuttle/syndicate/hallway)
"kk" = (
/obj/machinery/atmospherics/pipe/simple/supply/hidden{
	dir = 4
	},
/obj/effect/turf_decal/tile/red{
	dir = 1
	},
/obj/effect/turf_decal/tile/red{
	dir = 8
	},
/turf/open/floor/plasteel/dark,
/area/shuttle/syndicate/armory)
"kn" = (
/turf/closed/wall/mineral/plastitanium,
/area/shuttle/syndicate/bridge)
"kW" = (
/turf/closed/wall/mineral/plastitanium,
/area/shuttle/syndicate/airlock)
"lO" = (
/obj/effect/turf_decal/bot_white,
/obj/machinery/suit_storage_unit/syndicate{
	helmet_type = /obj/item/clothing/head/helmet/space/syndicate/contract;
	suit_type = /obj/item/clothing/suit/space/syndicate/contract
	},
/turf/open/floor/pod/light,
/area/shuttle/syndicate/eva)
"mj" = (
/obj/machinery/atmospherics/components/unary/vent_pump/on{
	dir = 4
	},
/obj/machinery/space_heater,
/obj/effect/turf_decal/stripes/line{
	dir = 6
	},
/turf/open/floor/plating,
/area/shuttle/syndicate)
"mz" = (
/obj/machinery/light/small{
	dir = 4
	},
/turf/open/floor/plasteel/dark,
/area/shuttle/syndicate/medical)
"ny" = (
/obj/machinery/atmospherics/pipe/simple/supply/hidden,
/turf/open/floor/plasteel/dark,
/area/shuttle/syndicate/armory)
"nT" = (
/obj/effect/turf_decal/tile/neutral{
	dir = 1
	},
/obj/effect/turf_decal/tile/neutral,
/obj/effect/turf_decal/tile/neutral{
	dir = 4
	},
/obj/effect/turf_decal/tile/neutral{
	dir = 8
	},
/obj/effect/turf_decal/tile/neutral{
	dir = 1
	},
/obj/effect/turf_decal/tile/neutral,
/obj/effect/turf_decal/tile/neutral{
	dir = 4
	},
/obj/effect/turf_decal/tile/neutral{
	dir = 8
	},
/obj/structure/chair/comfy/shuttle{
	dir = 4
	},
/turf/open/floor/plasteel/dark,
/area/shuttle/syndicate/bridge)
"nV" = (
/obj/machinery/atmospherics/components/unary/vent_pump/on,
/turf/open/floor/plasteel/dark,
/area/shuttle/syndicate)
"oy" = (
/obj/structure/table/reinforced,
/obj/machinery/recharger{
	pixel_x = -6;
	pixel_y = 6
	},
/obj/effect/turf_decal/tile/red,
/obj/item/clipboard{
	pixel_x = 7;
	pixel_y = 4
	},
/obj/item/folder/red{
	pixel_x = 7;
	pixel_y = 4
	},
/obj/item/pen{
	pixel_x = 7;
	pixel_y = 3
	},
/obj/machinery/light/small,
/turf/open/floor/plasteel/dark,
/area/shuttle/syndicate/bridge)
"oP" = (
/obj/machinery/atmospherics/components/unary/vent_pump/on{
	dir = 1
	},
/obj/effect/turf_decal/tile/neutral{
	dir = 1
	},
/obj/effect/turf_decal/tile/neutral,
/obj/effect/turf_decal/tile/neutral{
	dir = 4
	},
/obj/effect/turf_decal/tile/neutral{
	dir = 8
	},
/turf/open/floor/plasteel/dark,
/area/shuttle/syndicate/medical)
"qU" = (
/obj/structure/table,
/obj/item/circular_saw,
/obj/item/scalpel{
	pixel_y = 12
	},
/obj/item/cautery{
	pixel_x = 4
	},
/obj/machinery/light/small{
	dir = 8
	},
/turf/open/floor/plasteel/dark/side{
	dir = 4
	},
/area/shuttle/syndicate/medical)
"qW" = (
/obj/machinery/atmospherics/pipe/simple/supply/hidden,
/obj/machinery/door/airlock/security/glass{
	name = "Prison Cell";
	req_access_txt = "150"
	},
/turf/open/floor/plasteel/dark,
/area/shuttle/syndicate)
"rd" = (
/turf/template_noop,
/area/space)
"rV" = (
/obj/effect/turf_decal/tile/red{
	dir = 1
	},
/obj/effect/turf_decal/tile/red{
	dir = 8
	},
/obj/machinery/computer/shuttle/syndicate/infiltrator{
	dir = 8
	},
/turf/open/floor/plasteel/dark,
/area/shuttle/syndicate/bridge)
"sr" = (
/obj/machinery/door/airlock/security/glass{
	name = "Prison Cell";
	req_access_txt = "150"
	},
/turf/open/floor/plasteel/dark,
/area/shuttle/syndicate)
"sG" = (
/obj/structure/table,
/obj/structure/window/reinforced{
	dir = 8
	},
/obj/machinery/door/window/southleft{
	name = "Weapon Storage";
	req_access_txt = "150"
	},
/obj/effect/turf_decal/stripes/line,
/obj/item/grenade/c4,
/obj/item/grenade/c4{
	pixel_x = 8
	},
/obj/item/grenade/c4{
	pixel_x = 4
	},
/turf/open/floor/mineral/plastitanium,
/area/shuttle/syndicate/eva)
"tz" = (
/obj/structure/chair{
	dir = 4;
	name = "tactical chair"
	},
/obj/machinery/firealarm{
	dir = 8;
	pixel_x = -26
	},
/turf/open/floor/plasteel/dark/side{
	dir = 6
	},
/area/shuttle/syndicate/armory)
"tK" = (
/obj/structure/shuttle/engine/heater{
	dir = 8
	},
/obj/structure/window/reinforced{
	dir = 4
	},
/turf/open/floor/plating/airless,
/area/shuttle/syndicate)
"tX" = (
/obj/effect/turf_decal/tile/neutral{
	dir = 1
	},
/obj/effect/turf_decal/tile/neutral,
/obj/effect/turf_decal/tile/neutral{
	dir = 4
	},
/obj/effect/turf_decal/tile/neutral{
	dir = 8
	},
/turf/open/floor/plasteel/dark,
/area/shuttle/syndicate/eva)
"uo" = (
/obj/structure/rack,
/obj/item/aicard,
/obj/item/multitool,
/obj/effect/turf_decal/tile/red,
/turf/open/floor/plasteel/dark,
/area/shuttle/syndicate/armory)
"uN" = (
/obj/machinery/portable_atmospherics/canister/oxygen,
/obj/effect/turf_decal/tile/red{
	dir = 4
	},
/turf/open/floor/plasteel/dark,
/area/shuttle/syndicate/armory)
"vc" = (
/obj/structure/shuttle/engine/propulsion/burst{
	dir = 8
	},
/turf/open/floor/plating/airless,
/area/shuttle/syndicate)
"vr" = (
/obj/structure/shuttle/engine/propulsion/burst/right{
	dir = 8
	},
/turf/open/floor/plating/airless,
/area/shuttle/syndicate)
"vB" = (
/obj/machinery/light/small{
	dir = 1
	},
/obj/structure/closet/syndicate/personal,
/obj/item/pinpointer/crew/contractor,
/obj/item/pinpointer/crew/contractor,
/turf/open/floor/plasteel/dark,
/area/shuttle/syndicate/armory)
"vF" = (
/obj/effect/mapping_helpers/airlock/cyclelink_helper{
	dir = 2
	},
/obj/machinery/door/airlock/external{
	id_tag = "syndicatecutter_bolt_port";
	req_access_txt = "150"
	},
/obj/docking_port/mobile{
	callTime = 150;
	dir = 2;
	dwidth = 14;
	height = 13;
	id = "syndicatecutter;
	movement_force = list("KNOCKDOWN" = 0, "THROW" = 0);
	name = "Syndicate Cutter";
	port_direction = 8;
	preferred_direction = 4;
	width = 22
	},
/turf/open/floor/plating,
/area/shuttle/syndicate/airlock)
"wm" = (
/obj/machinery/porta_turret/syndicate{
	dir = 5
	},
/turf/closed/wall/mineral/plastitanium,
/area/shuttle/syndicate/armory)
"wu" = (
/obj/effect/mapping_helpers/airlock/cyclelink_helper{
	dir = 1
	},
/obj/machinery/door/airlock/external{
	id_tag = "syndicatecutter_bolt_port";
	req_access_txt = "150"
	},
/turf/open/floor/plating,
/area/shuttle/syndicate/airlock)
"wA" = (
/obj/machinery/atmospherics/components/unary/vent_pump/on,
/obj/effect/turf_decal/tile/neutral{
	dir = 1
	},
/obj/effect/turf_decal/tile/neutral,
/obj/effect/turf_decal/tile/neutral{
	dir = 4
	},
/obj/effect/turf_decal/tile/neutral{
	dir = 8
	},
/obj/machinery/turretid{
	icon_state = "control_kill";
	lethal = 1;
	locked = 1;
	pixel_x = 30;
	pixel_y = -33;
	req_access = 150
	},
/turf/open/floor/plasteel/dark,
/area/shuttle/syndicate/bridge)
"xA" = (
/obj/machinery/atmospherics/pipe/manifold/supply/hidden{
	dir = 8
	},
/obj/effect/turf_decal/tile/neutral{
	dir = 1
	},
/obj/effect/turf_decal/tile/neutral,
/obj/effect/turf_decal/tile/neutral{
	dir = 4
	},
/obj/effect/turf_decal/tile/neutral{
	dir = 8
	},
/turf/open/floor/plasteel/dark,
/area/shuttle/syndicate/armory)
"xS" = (
/obj/structure/table,
/obj/item/retractor,
/obj/item/hemostat,
/turf/open/floor/plasteel,
/area/shuttle/syndicate/medical)
"xX" = (
/obj/structure/table,
/obj/machinery/light{
	dir = 1
	},
/turf/open/floor/plasteel/dark/side{
	dir = 4
	},
/area/shuttle/syndicate/hallway)
"yy" = (
/obj/machinery/atmospherics/pipe/manifold/supply/hidden,
/turf/open/floor/plasteel/dark,
/area/shuttle/syndicate/hallway)
"yM" = (
/obj/machinery/porta_turret/syndicate{
	dir = 5
	},
/turf/closed/wall/mineral/plastitanium/nodiagonal,
/area/shuttle/syndicate/bridge)
"zj" = (
/obj/machinery/atmospherics/pipe/simple/supply/hidden{
	dir = 4
	},
/turf/open/floor/plasteel/dark,
/area/shuttle/syndicate/hallway)
"zJ" = (
/obj/machinery/atmospherics/pipe/simple/supply/hidden,
/turf/open/floor/plasteel/dark,
/area/shuttle/syndicate)
"Ae" = (
/turf/closed/wall/mineral/plastitanium/nodiagonal,
/area/shuttle/syndicate)
"Ai" = (
/obj/machinery/button/door{
	id = "syndicatecutter_bridge";
	name = "Bridge Blast Door Control";
	pixel_x = 25;
	pixel_y = 8;
	req_access_txt = "150"
	},
/obj/machinery/atmospherics/pipe/simple/supply/hidden{
	dir = 9
	},
/obj/structure/chair/comfy/shuttle,
/turf/open/floor/plasteel/dark,
/area/shuttle/syndicate/bridge)
"AG" = (
/obj/machinery/computer/camera_advanced/syndie{
	dir = 2
	},
/turf/open/floor/plasteel/dark,
/area/shuttle/syndicate/bridge)
"BJ" = (
/obj/structure/table,
/obj/effect/turf_decal/stripes/line,
/obj/machinery/airalarm{
	pixel_y = 24;
	req_access = 150
	},
/turf/open/floor/mineral/plastitanium,
/area/shuttle/syndicate/eva)
"Ck" = (
/obj/effect/turf_decal/tile/red,
/obj/effect/turf_decal/tile/red{
	dir = 8
	},
/obj/machinery/atmospherics/pipe/simple/supply/hidden{
	dir = 4
	},
/turf/open/floor/plasteel/dark,
/area/shuttle/syndicate/eva)
"Cq" = (
/obj/machinery/atmospherics/pipe/simple/supply/hidden,
/obj/structure/cable{
	icon_state = "1-8"
	},
/turf/open/floor/plating,
/area/shuttle/syndicate)
"CO" = (
/obj/machinery/atmospherics/pipe/simple/supply/hidden{
	dir = 4
	},
/turf/open/floor/plasteel/dark,
/area/shuttle/syndicate/medical)
"Da" = (
/obj/machinery/atmospherics/pipe/manifold/supply/hidden{
	dir = 4
	},
/turf/open/floor/plating,
/area/shuttle/syndicate)
"DC" = (
/obj/effect/turf_decal/tile/neutral{
	dir = 1
	},
/obj/effect/turf_decal/tile/neutral,
/obj/effect/turf_decal/tile/neutral{
	dir = 4
	},
/obj/effect/turf_decal/tile/neutral{
	dir = 8
	},
/turf/open/floor/plasteel/dark,
/area/shuttle/syndicate/medical)
"EU" = (
/obj/structure/chair{
	dir = 4;
	name = "tactical chair"
	},
/turf/open/floor/plasteel/dark,
/area/shuttle/syndicate)
"EY" = (
/obj/machinery/atmospherics/pipe/simple/supply/hidden{
	dir = 4
	},
/obj/machinery/door/airlock/engineering{
	name = "Engineering";
	req_access_txt = "150"
	},
/obj/machinery/door/firedoor/border_only{
	dir = 4
	},
/obj/machinery/door/firedoor/border_only{
	dir = 8
	},
/turf/open/floor/plating,
/area/shuttle/syndicate)
"EZ" = (
/obj/effect/mapping_helpers/airlock/cyclelink_helper{
	dir = 1
	},
/obj/effect/mapping_helpers/airlock/locked,
/obj/machinery/door/airlock/external{
	id_tag = "syndicatecutter_bolt_starboard";
	req_access_txt = "150"
	},
/turf/open/floor/plating,
/area/shuttle/syndicate/airlock)
"Fs" = (
/obj/machinery/atmospherics/pipe/simple/supply/hidden{
	dir = 5
	},
/turf/open/floor/plating,
/area/shuttle/syndicate)
"GH" = (
/obj/structure/reagent_dispensers/watertank,
/obj/item/reagent_containers/glass/bucket,
/obj/item/mop,
/obj/effect/turf_decal/stripes/line{
	dir = 5
	},
/turf/open/floor/plating,
/area/shuttle/syndicate)
"Hc" = (
/obj/machinery/light/small{
	dir = 8
	},
/obj/structure/sign/warning/vacuum{
	pixel_x = -32
	},
/obj/structure/fans/tiny,
/turf/open/floor/plating,
/area/shuttle/syndicate/airlock)
"Hf" = (
/obj/machinery/computer/med_data/syndie{
	dir = 1
	},
/obj/effect/turf_decal/tile/red{
	dir = 1
	},
/turf/open/floor/plasteel/dark,
/area/shuttle/syndicate/armory)
"IF" = (
/obj/machinery/atmospherics/pipe/simple/supply/hidden,
/obj/effect/turf_decal/tile/neutral{
	dir = 1
	},
/obj/effect/turf_decal/tile/neutral,
/obj/effect/turf_decal/tile/neutral{
	dir = 4
	},
/obj/effect/turf_decal/tile/neutral{
	dir = 8
	},
/turf/open/floor/plasteel/dark,
/area/shuttle/syndicate/armory)
"IP" = (
/obj/structure/reagent_dispensers/fueltank,
/obj/effect/turf_decal/stripes/line{
	dir = 4
	},
/turf/open/floor/plating,
/area/shuttle/syndicate)
"Jt" = (
/turf/closed/wall/mineral/plastitanium/nodiagonal,
/area/shuttle/syndicate/bridge)
"Jx" = (
/obj/machinery/atmospherics/pipe/simple/supply/hidden{
	dir = 10
	},
/obj/effect/turf_decal/tile/neutral{
	dir = 1
	},
/obj/effect/turf_decal/tile/neutral,
/obj/effect/turf_decal/tile/neutral{
	dir = 4
	},
/obj/effect/turf_decal/tile/neutral{
	dir = 8
	},
/turf/open/floor/plasteel/dark,
/area/shuttle/syndicate/armory)
"KC" = (
/obj/effect/mapping_helpers/airlock/cyclelink_helper{
	dir = 2
	},
/obj/effect/mapping_helpers/airlock/locked,
/obj/machinery/door/airlock/external{
	id_tag = "syndicatecutter_bolt_starboard";
	req_access_txt = "150"
	},
/turf/open/floor/plating,
/area/shuttle/syndicate/airlock)
"KR" = (
/obj/machinery/door/poddoor{
	id = "syndicatecutter_bridge"
	},
/obj/effect/spawner/structure/window/plasma/reinforced/plastitanium,
/turf/open/floor/plating,
/area/shuttle/syndicate)
"Lt" = (
/turf/closed/wall/mineral/plastitanium/nodiagonal,
/area/shuttle/syndicate/armory)
"Lv" = (
/obj/machinery/power/port_gen/pacman{
	anchored = 1
	},
/obj/item/wrench,
/obj/effect/turf_decal/stripes/line{
	dir = 6
	},
/obj/structure/cable,
/turf/open/floor/plating,
/area/shuttle/syndicate)
"LR" = (
/obj/machinery/atmospherics/components/unary/tank/air,
/obj/effect/turf_decal/bot,
/turf/open/floor/plating,
/area/shuttle/syndicate)
"MD" = (
/obj/machinery/light,
/obj/structure/table,
/turf/open/floor/plasteel/dark/side{
	dir = 4
	},
/area/shuttle/syndicate/hallway)
"NG" = (
/obj/machinery/atmospherics/pipe/simple/supply/hidden{
	dir = 4
	},
/obj/machinery/door/airlock/hatch{
	name = "Cockpit";
	req_access_txt = "150"
	},
/obj/machinery/door/firedoor/border_only{
	dir = 4
	},
/obj/machinery/door/firedoor/border_only{
	dir = 8
	},
/turf/open/floor/plasteel/dark,
/area/shuttle/syndicate/bridge)
"NN" = (
/obj/structure/table/optable,
/obj/effect/turf_decal/bot,
/turf/open/floor/plasteel,
/area/shuttle/syndicate/medical)
"OJ" = (
/obj/machinery/atmospherics/components/unary/vent_pump/on{
	dir = 4
	},
/obj/machinery/light/small{
	dir = 8
	},
/obj/structure/chair{
	dir = 4;
	name = "tactical chair"
	},
/obj/structure/extinguisher_cabinet{
	pixel_x = -27
	},
/turf/open/floor/plasteel/dark,
/area/shuttle/syndicate/armory)
"OM" = (
/obj/effect/turf_decal/delivery,
/obj/machinery/airalarm{
	dir = 1;
	pixel_y = -24;
	req_access = null;
	req_access_txt = "150"
	},
/obj/machinery/sleeper/syndie/fullupgrade{
	dir = 1
	},
/turf/open/floor/plasteel,
/area/shuttle/syndicate/medical)
"ON" = (
/obj/machinery/status_display,
/turf/closed/wall/mineral/plastitanium/nodiagonal,
/area/shuttle/syndicate/medical)
"OP" = (
/obj/machinery/light/small,
/obj/machinery/computer/secure_data/syndie{
	dir = 1
	},
/turf/open/floor/plasteel/dark,
/area/shuttle/syndicate/armory)
"OT" = (
/obj/machinery/atmospherics/pipe/simple/supply/hidden{
	dir = 4
	},
/obj/effect/turf_decal/tile/red{
	dir = 1
	},
/obj/effect/turf_decal/tile/red,
/obj/effect/turf_decal/tile/red{
	dir = 8
	},
/turf/open/floor/plasteel/dark,
/area/shuttle/syndicate/eva)
"Pb" = (
/obj/machinery/button/door{
	id = "syndicatecutter_bolt_starboard";
	name = "External Bolt Control";
	normaldoorcontrol = 1;
	pixel_x = -4;
	pixel_y = -25;
	req_access_txt = "150";
	specialfunctions = 4
	},
/obj/machinery/atmospherics/pipe/simple/supply/hidden{
	dir = 4
	},
/obj/effect/turf_decal/tile/red,
/obj/effect/turf_decal/tile/red{
	dir = 8
	},
/turf/open/floor/plasteel/dark,
/area/shuttle/syndicate/eva)
"Pc" = (
/obj/structure/table,
/obj/item/storage/box/handcuffs,
/obj/item/clothing/mask/muzzle,
/obj/item/clothing/mask/muzzle{
	pixel_y = 04
	},
/turf/open/floor/plasteel/dark,
/area/shuttle/syndicate)
"PC" = (
/obj/structure/table,
/obj/machinery/firealarm{
	dir = 1;
	pixel_y = -24
	},
/obj/item/storage/firstaid/tactical,
/obj/item/storage/firstaid/tactical/spec{
	pixel_y = -8
	},
/turf/open/floor/plasteel,
/area/shuttle/syndicate/medical)
"Qe" = (
/obj/machinery/light/small{
	dir = 8
	},
/obj/structure/closet/crate/secure/weapon,
/obj/effect/turf_decal/tile/red{
	dir = 1
	},
/obj/effect/turf_decal/tile/red{
	dir = 8
	},
/obj/item/melee/classic_baton/telescopic/contractor_baton,
/obj/item/melee/classic_baton/telescopic/contractor_baton{
	pixel_x = 8
	},
/obj/item/melee/classic_baton/telescopic/contractor_baton{
	pixel_x = 4
	},
/obj/item/melee/classic_baton/telescopic/contractor_baton{
	pixel_x = 2
	},
/turf/open/floor/plasteel/dark,
/area/shuttle/syndicate/eva)
"QP" = (
/turf/open/floor/plasteel/dark/side{
	dir = 4
	},
/area/shuttle/syndicate/armory)
"QV" = (
/obj/structure/table/reinforced,
/obj/item/storage/toolbox/syndicate,
/obj/item/crowbar/red,
/turf/open/floor/plasteel/dark,
/area/shuttle/syndicate/armory)
"Rn" = (
/turf/closed/wall/mineral/plastitanium/nodiagonal,
/area/shuttle/syndicate/medical)
"Ro" = (
/obj/machinery/atmospherics/pipe/simple/supply/hidden{
	dir = 4
	},
/obj/machinery/door/airlock/medical/glass{
	name = "Medbay"
	},
/obj/machinery/door/firedoor/border_only{
	dir = 4
	},
/obj/machinery/door/firedoor/border_only{
	dir = 8
	},
/turf/open/floor/plasteel/dark,
/area/shuttle/syndicate/medical)
"RD" = (
/turf/closed/wall/mineral/plastitanium/nodiagonal,
/area/shuttle/syndicate/airlock)
"RI" = (
/obj/machinery/power/terminal{
	dir = 1
	},
/obj/structure/closet/crate,
/obj/item/stack/sheet/metal/twenty,
/obj/item/stack/sheet/glass{
	amount = 10
	},
/obj/effect/turf_decal/stripes/line{
	dir = 4
	},
/obj/item/storage/toolbox/syndicate,
/obj/item/flashlight{
	pixel_x = 3;
	pixel_y = 3
	},
/obj/item/stack/sheet/mineral/plasma{
	amount = 20
	},
/obj/structure/cable{
	icon_state = "0-2"
	},
/turf/open/floor/plating,
/area/shuttle/syndicate)
"RX" = (
/turf/closed/wall/mineral/plastitanium,
/area/shuttle/syndicate)
"Sv" = (
/obj/structure/table/reinforced,
/turf/open/floor/plasteel/dark,
/area/shuttle/syndicate/bridge)
"TL" = (
/obj/machinery/atmospherics/components/unary/vent_pump/on,
/obj/effect/turf_decal/tile/neutral{
	dir = 1
	},
/obj/effect/turf_decal/tile/neutral,
/obj/effect/turf_decal/tile/neutral{
	dir = 4
	},
/obj/effect/turf_decal/tile/neutral{
	dir = 8
	},
/turf/open/floor/plasteel/dark,
/area/shuttle/syndicate/eva)
"TY" = (
/turf/closed/wall/mineral/plastitanium/nodiagonal,
/area/shuttle/syndicate/hallway)
"Ua" = (
/obj/machinery/atmospherics/pipe/simple/supply/hidden{
	dir = 9
	},
/obj/effect/turf_decal/tile/neutral{
	dir = 1
	},
/obj/effect/turf_decal/tile/neutral,
/obj/effect/turf_decal/tile/neutral{
	dir = 4
	},
/obj/effect/turf_decal/tile/neutral{
	dir = 8
	},
/turf/open/floor/plasteel/dark,
/area/shuttle/syndicate/armory)
"UO" = (
/obj/effect/turf_decal/bot,
/obj/structure/closet/crate/freezer/blood,
/turf/open/floor/plasteel,
/area/shuttle/syndicate/medical)
"Vn" = (
/obj/machinery/atmospherics/pipe/manifold/supply/hidden,
/obj/effect/turf_decal/caution/stand_clear/white{
	dir = 1
	},
/obj/effect/turf_decal/tile/red,
/obj/effect/turf_decal/tile/red{
	dir = 8
	},
/turf/open/floor/plasteel/dark,
/area/shuttle/syndicate/eva)
"Vp" = (
/obj/machinery/status_display,
/turf/closed/wall/mineral/plastitanium/nodiagonal,
/area/shuttle/syndicate/armory)
"VF" = (
/obj/structure/table,
/turf/open/floor/plasteel/dark/side{
	dir = 4
	},
/area/shuttle/syndicate/hallway)
"VX" = (
/obj/machinery/atmospherics/pipe/simple/supply/hidden{
	dir = 4
	},
/obj/effect/turf_decal/tile/red,
/obj/effect/turf_decal/tile/red{
	dir = 4
	},
/turf/open/floor/plasteel/dark,
/area/shuttle/syndicate/armory)
"Wh" = (
/obj/structure/table,
/obj/machinery/cell_charger,
/obj/item/stack/cable_coil,
/obj/item/stock_parts/cell/high,
/obj/effect/turf_decal/bot,
/turf/open/floor/plating,
/area/shuttle/syndicate)
"Wv" = (
/obj/machinery/door/poddoor{
	id = "syndicatecutter_bridge"
	},
/obj/effect/spawner/structure/window/plasma/reinforced/plastitanium,
/turf/open/floor/plating,
/area/shuttle/syndicate/bridge)
"WL" = (
/obj/machinery/atmospherics/pipe/simple/supply/hidden{
	dir = 4
	},
/obj/machinery/defibrillator_mount/loaded{
	pixel_y = 28
	},
/turf/open/floor/plasteel/dark/side,
/area/shuttle/syndicate/medical)
"WO" = (
/turf/open/floor/plasteel/dark,
/area/shuttle/syndicate)
"XH" = (
/obj/structure/sign/warning/securearea,
/turf/closed/wall/mineral/plastitanium/nodiagonal,
/area/shuttle/syndicate/hallway)
"YA" = (
/obj/machinery/atmospherics/pipe/manifold/supply/hidden{
	dir = 1
	},
/obj/effect/turf_decal/caution/stand_clear/white,
/turf/open/floor/plasteel/dark/side,
/area/shuttle/syndicate/medical)
"YL" = (
/obj/structure/closet/syndicate/personal,
/obj/item/pinpointer/crew/contractor,
/obj/item/pinpointer/crew/contractor,
/turf/open/floor/plasteel/dark/side{
	dir = 5
	},
/area/shuttle/syndicate/armory)
"YN" = (
/obj/effect/turf_decal/tile/red{
	dir = 1
	},
/obj/effect/turf_decal/tile/red{
	dir = 4
	},
/obj/machinery/light/small{
	dir = 1
	},
/obj/machinery/computer/camera_advanced/shuttle_docker/syndicate/infiltrator,
/turf/open/floor/plasteel/dark,
/area/shuttle/syndicate/bridge)
"ZE" = (
/obj/structure/sign/departments/engineering,
/turf/closed/wall/mineral/plastitanium/nodiagonal,
/area/shuttle/syndicate)
"ZL" = (
/obj/structure/tank_dispenser/oxygen,
/obj/machinery/firealarm{
	dir = 2;
	pixel_y = 24
	},
/obj/effect/turf_decal/stripes/line,
/turf/open/floor/mineral/plastitanium,
/area/shuttle/syndicate/eva)
"ZM" = (
/obj/machinery/atmospherics/pipe/simple/supply/hidden{
	dir = 4
	},
/turf/open/floor/plasteel/dark/corner,
/area/shuttle/syndicate/medical)
"ZN" = (
/obj/structure/closet/syndicate/personal,
/obj/item/pinpointer/crew/contractor,
/obj/item/pinpointer/crew/contractor,
/turf/open/floor/plasteel/dark/side{
	dir = 5
	},
/area/shuttle/syndicate/hallway)
"ZP" = (
/obj/structure/table,
/obj/machinery/door/window/southleft{
	base_state = "right";
	icon_state = "right";
	name = "Weapon Storage";
	req_access_txt = "150"
	},
/obj/effect/turf_decal/stripes/line,
/obj/item/grenade/flashbang{
	pixel_x = -11
	},
/obj/item/grenade/flashbang{
	pixel_x = -3
	},
/obj/item/grenade/flashbang{
	pixel_x = 5
	},
/turf/open/floor/mineral/plastitanium,
/area/shuttle/syndicate/eva)

(1,1,1) = {"
rd
rd
rd
iQ
vc
vr
rd
iQ
vc
vr
rd
rd
rd
"}
(2,1,1) = {"
rd
rd
RX
tK
tK
tK
Ae
tK
tK
tK
RX
rd
rd
"}
(3,1,1) = {"
rd
cu
Ae
GH
IP
mj
Ae
ev
RI
Lv
Ae
iq
rd
"}
(4,1,1) = {"
rd
Ae
LR
il
eQ
Da
hi
Cq
eQ
Fs
Wh
Ae
rd
"}
(5,1,1) = {"
rd
Ae
Ae
EY
ZE
Ae
Ae
Ae
ZE
EY
Ae
Ae
rd
"}
(6,1,1) = {"
rd
Ae
lO
ZM
qU
xS
ON
gL
Qe
OT
lO
Ae
rd
"}
(7,1,1) = {"
kW
RD
RD
WL
DC
NN
Rn
BJ
tX
aJ
RD
RD
kW
"}
(8,1,1) = {"
vF
Hc
wu
YA
oP
PC
Rn
ZL
TL
Vn
KC
Hc
EZ
"}
(9,1,1) = {"
RX
RD
RD
dn
DC
OM
Rn
sG
tX
Pb
RD
RD
kW
"}
(10,1,1) = {"
rd
KR
lO
CO
mz
UO
ON
ZP
gI
Ck
lO
KR
rd
"}
(11,1,1) = {"
rd
RX
Rn
Ro
jv
Rn
Rn
TY
XH
jG
Ae
RX
rd
"}
(12,1,1) = {"
rd
TY
VF
zj
Ae
EU
Pc
EU
Ae
zj
VF
TY
rd
"}
(13,1,1) = {"
rd
TY
xX
zj
sr
WO
nV
zJ
qW
yy
MD
TY
rd
"}
(14,1,1) = {"
rd
TY
ZN
zj
Ae
gf
Pc
gf
Ae
zj
VF
TY
rd
"}
(15,1,1) = {"
rd
TY
ZN
zj
Ae
Ae
Ae
Ae
Ae
zj
VF
TY
rd
"}
(16,1,1) = {"
rd
Lt
YL
iD
QP
tz
OJ
iI
gX
kk
Hf
Lt
rd
"}
(17,1,1) = {"
rd
Lt
vB
Jx
IF
IF
fJ
xA
ny
Ua
OP
Lt
rd
"}
(18,1,1) = {"
rd
wm
Vp
Lt
hu
QV
uo
VX
uN
Lt
Vp
iu
rd
"}
(19,1,1) = {"
rd
rd
kn
kn
Jt
Jt
Jt
NG
Jt
kn
kn
rd
rd
"}
(20,1,1) = {"
rd
rd
rd
Wv
gR
jp
eF
eM
oy
Wv
rd
rd
rd
"}
(21,1,1) = {"
rd
rd
rd
Wv
AG
dX
wA
Ai
aB
Wv
rd
rd
rd
"}
(22,1,1) = {"
rd
rd
rd
Jt
Jt
YN
nT
Sv
Jt
Jt
rd
rd
rd
"}
(23,1,1) = {"
rd
rd
rd
rd
yM
Wv
rV
Wv
eb
rd
rd
rd
rd
"}
(24,1,1) = {"
rd
rd
rd
rd
rd
Wv
Wv
Wv
rd
rd
rd
rd
rd
"}
(25,1,1) = {"
rd
rd
rd
rd
rd
rd
rd
rd
rd
rd
rd
rd
rd
"}
(26,1,1) = {"
rd
rd
rd
rd
rd
rd
rd
rd
rd
rd
rd
rd
rd
"}
(27,1,1) = {"
rd
rd
rd
rd
rd
rd
rd
rd
rd
rd
rd
rd
rd
"}
(28,1,1) = {"
rd
rd
rd
rd
rd
rd
rd
rd
rd
rd
rd
rd
rd
"}
(29,1,1) = {"
rd
rd
rd
rd
rd
rd
rd
rd
rd
rd
rd
rd
rd
"}
(30,1,1) = {"
rd
rd
rd
rd
rd
rd
rd
rd
rd
rd
rd
rd
rd
"}
