//MAP CONVERTED BY dmm2tgm.py THIS HEADER COMMENT PREVENTS RECONVERSION, DO NOT REMOVE
"a" = (
/obj/machinery/portable_atmospherics/canister/carbon_dioxide,
/obj/machinery/atmospherics/components/unary/portables_connector{
	dir = 1
	},
/turf/open/floor/plating,
/area/shuttle/nts/falcon)
"d" = (
/obj/effect/spawner/structure/window/shuttle,
/turf/open/floor/plating,
/area/shuttle/nts/falcon)
"f" = (
/obj/machinery/power/apc/auto_name/north,
/obj/structure/cable,
/obj/machinery/airalarm/directional/west,
/turf/open/floor/plasteel/shuttle,
/area/shuttle/nts/falcon)
"g" = (
/obj/structure/toilet,
/obj/machinery/light{
	dir = 1
	},
/turf/open/floor/plasteel/shuttle,
/area/shuttle/nts/falcon)
"h" = (
/obj/machinery/suit_storage_unit,
/turf/open/floor/plasteel/shuttle,
/area/shuttle/nts/falcon)
"j" = (
/turf/template_noop,
/area/template_noop)
"k" = (
/obj/structure/closet,
/turf/open/floor/plasteel/shuttle,
/area/shuttle/nts/falcon)
"q" = (
/obj/structure/chair/office{
	dir = 1
	},
/turf/open/floor/plasteel/shuttle,
/area/shuttle/nts/falcon)
"r" = (
/obj/machinery/door/airlock/external/glass,
/obj/structure/cable,
/obj/structure/fans/tiny,
/turf/open/floor/plating,
/area/shuttle/nts/falcon)
"t" = (
/obj/structure/frame/machine,
/turf/open/floor/plasteel/shuttle,
/area/shuttle/nts/falcon)
"u" = (
/obj/machinery/atmospherics/pipe/simple/orange/hidden{
	dir = 10
	},
/turf/open/floor/plating,
/area/shuttle/nts/falcon)
"v" = (
/obj/machinery/atmospherics/pipe/simple/orange/hidden{
	dir = 6
	},
/turf/closed/wall/mineral/titanium,
/area/shuttle/nts/falcon)
"y" = (
/obj/structure/sink{
	dir = 8;
	pixel_x = 11
	},
/obj/structure/mirror{
	pixel_x = 28
	},
/turf/open/floor/plasteel/shuttle,
/area/shuttle/nts/falcon)
"z" = (
/obj/structure/cable,
/turf/open/floor/plasteel/shuttle,
/area/shuttle/nts/falcon)
"A" = (
/obj/machinery/atmospherics/pipe/simple/orange/hidden{
	dir = 4
	},
/obj/structure/closet/crate{
	icon_state = "crateopen"
	},
/turf/open/floor/plating,
/area/shuttle/nts/falcon)
"B" = (
/obj/structure/bed/pod,
/obj/structure/curtain/cloth,
/obj/item/bedsheet,
/turf/open/floor/plasteel/shuttle,
/area/shuttle/nts/falcon)
"G" = (
/obj/structure/table,
/obj/machinery/light{
	dir = 1
	},
/turf/open/floor/plasteel/shuttle,
/area/shuttle/nts/falcon)
"H" = (
/obj/machinery/shower{
	dir = 8
	},
/turf/open/floor/plasteel/shuttle,
/area/shuttle/nts/falcon)
"I" = (
/obj/structure/table,
/obj/effect/spawner/lootdrop/donkpockets,
/obj/machinery/light,
/turf/open/floor/plasteel/shuttle,
/area/shuttle/nts/falcon)
"J" = (
/obj/machinery/atmospherics/components/unary/engine,
/turf/open/floor/plating/airless,
/area/shuttle/nts/falcon)
"K" = (
/obj/effect/turf_decal/stripes/asteroid/line,
/turf/open/floor/plasteel/shuttle,
/area/shuttle/nts/falcon)
"N" = (
/obj/structure/shuttle/engine/heater,
/obj/machinery/atmospherics/pipe/simple/orange/visible,
/turf/open/floor/plating/airless,
/area/shuttle/nts/falcon)
"O" = (
/obj/machinery/computer/shuttle/nts/falcon,
/turf/open/floor/plasteel/shuttle,
/area/shuttle/nts/falcon)
"P" = (
/obj/machinery/door/airlock/shuttle,
/turf/open/floor/plasteel/shuttle,
/area/shuttle/nts/falcon)
"Q" = (
/obj/machinery/door/airlock/silver{
	name = "Bathroom"
	},
/turf/open/floor/plasteel/shuttle,
/area/shuttle/nts/falcon)
"S" = (
/obj/machinery/door/airlock/command/glass,
/turf/open/floor/plasteel/shuttle,
/area/shuttle/nts/falcon)
"T" = (
/turf/closed/wall/mineral/titanium,
/area/shuttle/nts/falcon)
"U" = (
/obj/machinery/light,
/turf/open/floor/plasteel/shuttle,
/area/shuttle/nts/falcon)
"W" = (
/obj/docking_port/mobile{
	dheight = 1;
	dwidth = 3;
	height = 6;
	id = "falcon";
	movement_force = list("KNOCKDOWN" = 0, "THROW" = 0);
	name = "NTS Falcon";
	width = 5
	},
/turf/closed/wall/mineral/titanium,
/area/shuttle/nts/falcon)
"Y" = (
/turf/open/floor/plasteel/shuttle,
/area/shuttle/nts/falcon)
"Z" = (
/obj/machinery/atmospherics/pipe/simple/orange/hidden{
	dir = 4
	},
/turf/closed/wall/mineral/titanium,
/area/shuttle/nts/falcon)

(1,1,1) = {"
j
T
d
d
T
T
r
T
T
T
j
"}
(2,1,1) = {"
T
T
k
k
T
f
z
h
v
N
J
"}
(3,1,1) = {"
T
B
Y
Y
P
Y
Y
h
Z
T
j
"}
(4,1,1) = {"
T
B
Y
I
T
t
Y
K
A
W
T
"}
(5,1,1) = {"
T
T
S
T
T
G
Y
K
u
a
T
"}
(6,1,1) = {"
j
d
Y
U
T
T
Q
T
T
T
T
"}
(7,1,1) = {"
j
d
O
q
T
g
y
H
T
j
j
"}
(8,1,1) = {"
j
T
T
T
T
T
T
T
T
j
j
"}
