"a" = (/turf/template_noop,/area/template_noop)
"b" = (/obj/effect/turf_decal/siding/purple{dir = 5},/turf/open/water/jungle{color = "#8355b0"},/area/ruin/space/has_grav/powered/aesthetic)
"c" = (/obj/structure/statue/sandstone/venus{anchored = 1},/turf/open/floor/plating/asteroid,/area/ruin/space/has_grav/powered/aesthetic)
"f" = (/turf/open/floor/plastic,/area/ruin/space/has_grav/powered/aesthetic)
"o" = (/obj/effect/turf_decal/siding/purple{dir = 4},/turf/open/water/jungle{color = "#8355b0"},/area/ruin/space/has_grav/powered/aesthetic)
"p" = (/obj/machinery/shower{dir = 8},/turf/open/floor/plastic,/area/ruin/space/has_grav/powered/aesthetic)
"t" = (/obj/item/statuebust,/turf/open/floor/plastic,/area/ruin/space/has_grav/powered/aesthetic)
"w" = (/obj/machinery/door/airlock/titanium/glass,/obj/structure/fans/tiny,/turf/open/floor/plastic,/area/ruin/space/has_grav/powered/aesthetic)
"y" = (/obj/structure/statue/sandstone/venus{anchored = 1; dir = 8},/turf/open/floor/plating/asteroid,/area/ruin/space/has_grav/powered/aesthetic)
"A" = (/obj/structure/chair/plastic{dir = 8},/turf/open/floor/plastic,/area/ruin/space/has_grav/powered/aesthetic)
"E" = (/obj/machinery/light{color = "#8355b0"; dir = 1},/turf/open/floor/plastic,/area/ruin/space/has_grav/powered/aesthetic)
"F" = (/obj/item/mop,/obj/machinery/light{color = "#8355b0"},/obj/item/reagent_containers/glass/bucket{pixel_x = 8; pixel_y = -6},/obj/structure/sink{dir = 8; pixel_x = 13},/turf/open/floor/plastic,/area/ruin/powered)
"G" = (/obj/item/chair/plastic{pixel_y = 5},/obj/machinery/light{color = "#8355b0"},/turf/open/floor/plastic,/area/ruin/space/has_grav/powered/aesthetic)
"I" = (/turf/closed/wall/mineral/titanium,/area/ruin/space/has_grav/powered/aesthetic)
"J" = (/obj/machinery/shower{dir = 4},/turf/open/floor/plastic,/area/ruin/space/has_grav/powered/aesthetic)
"K" = (/turf/open/water/jungle{color = "#8355b0"},/area/ruin/space/has_grav/powered/aesthetic)
"L" = (/turf/open/floor/plating/asteroid,/area/ruin/space/has_grav/powered/aesthetic)
"M" = (/obj/effect/turf_decal/siding/purple{dir = 1},/turf/open/water/jungle{color = "#8355b0"},/area/ruin/space/has_grav/powered/aesthetic)
"Q" = (/obj/structure/bedsheetbin,/turf/open/floor/plastic,/area/ruin/powered)
"R" = (/obj/item/bikehorn/rubberducky/plasticducky,/obj/effect/turf_decal/siding/purple{dir = 10},/turf/open/water/jungle{color = "#8355b0"},/area/ruin/space/has_grav/powered/aesthetic)
"S" = (/obj/effect/turf_decal/siding/purple{dir = 9},/turf/open/water/jungle{color = "#8355b0"},/area/ruin/space/has_grav/powered/aesthetic)
"T" = (/obj/effect/turf_decal/siding/purple{dir = 6},/turf/open/water/jungle{color = "#8355b0"},/area/ruin/space/has_grav/powered/aesthetic)
"W" = (/turf/open/floor/plastic,/area/ruin/powered)
"X" = (/obj/effect/turf_decal/siding/purple,/turf/open/water/jungle{color = "#8355b0"},/area/ruin/space/has_grav/powered/aesthetic)
"Y" = (/obj/effect/turf_decal/siding/purple{dir = 8},/turf/open/water/jungle{color = "#8355b0"},/area/ruin/space/has_grav/powered/aesthetic)

(1,1,1) = {"
aaaIIIaaa
aIIIIIIIa
aIJEtEpIa
aIfSMbfIa
aIfYKofIa
aIfRXTAIa
aIGfWQFIa
aIIIwIIIa
aaIcLyIaa
"}
