"a" = (/turf/template_noop,/area/template_noop)
"l" = (/obj/machinery/chem_master/condimaster,/obj/effect/turf_decal/tile/green,/obj/effect/turf_decal/tile/green{dir = 1},/turf/open/floor/plasteel,/area/ruin/powered)
"m" = (/obj/machinery/light,/obj/effect/turf_decal/tile/green,/obj/effect/turf_decal/tile/green{dir = 1},/turf/open/floor/plasteel,/area/ruin/powered)
"n" = (/obj/machinery/biogenerator,/obj/effect/turf_decal/tile/green,/obj/effect/turf_decal/tile/green{dir = 1},/turf/open/floor/plasteel,/area/ruin/powered)
"o" = (/obj/machinery/seed_extractor,/obj/effect/turf_decal/tile/green,/obj/effect/turf_decal/tile/green{dir = 1},/turf/open/floor/plasteel,/area/ruin/powered)
"s" = (/obj/effect/turf_decal/tile/green,/turf/open/floor/plasteel,/area/ruin/powered)
"t" = (/obj/structure/table/glass,/obj/effect/turf_decal/tile/green,/obj/effect/turf_decal/tile/green{dir = 1},/obj/machinery/reagentgrinder{pixel_y = 13},/turf/open/floor/plasteel,/area/ruin/powered)
"w" = (/obj/effect/turf_decal/tile/green,/obj/effect/turf_decal/tile/green{dir = 1},/turf/open/floor/plasteel,/area/ruin/powered)
"y" = (/turf/closed/wall/mineral/titanium,/area/ruin/powered)
"B" = (/obj/structure/table/wood,/obj/item/plant_analyzer,/obj/item/plant_analyzer,/obj/item/plant_analyzer,/obj/item/storage/bag/plants,/obj/item/storage/bag/plants,/obj/item/storage/bag/plants,/obj/item/reagent_containers/glass/bucket,/obj/item/reagent_containers/glass/bucket,/obj/item/reagent_containers/glass/bucket,/obj/effect/turf_decal/tile/green{dir = 1},/turf/open/floor/plasteel,/area/ruin/powered)
"C" = (/obj/structure/table/wood,/obj/item/cultivator,/obj/item/cultivator,/obj/item/cultivator,/obj/item/shovel/spade,/obj/item/shovel/spade,/obj/item/shovel/spade,/obj/item/secateurs,/obj/item/secateurs,/obj/item/secateurs,/obj/effect/turf_decal/tile/green{dir = 1},/turf/open/floor/plasteel,/area/ruin/powered)
"D" = (/obj/structure/reagent_dispensers/watertank,/obj/effect/turf_decal/tile/green,/obj/effect/turf_decal/tile/green{dir = 1},/turf/open/floor/plasteel,/area/ruin/powered)
"J" = (/obj/structure/fans/tiny,/obj/machinery/door/airlock/wood/glass,/turf/open/floor/plasteel,/area/ruin/powered)
"L" = (/obj/machinery/light{dir = 1},/obj/machinery/smartfridge/food,/obj/effect/turf_decal/tile/green,/obj/effect/turf_decal/tile/green{dir = 1},/turf/open/floor/plasteel,/area/ruin/powered)
"N" = (/obj/structure/table/wood,/obj/effect/spawner/lootdrop/space/rareseed,/obj/item/seeds/apple,/obj/item/seeds/banana,/obj/item/seeds/berry,/obj/item/seeds/cabbage,/obj/item/seeds/carrot,/obj/item/seeds/eggplant,/obj/item/seeds/lemon,/obj/item/seeds/onion,/obj/item/seeds/orange,/obj/item/seeds/poppy,/obj/item/seeds/potato,/obj/item/seeds/pumpkin,/obj/item/seeds/tomato,/obj/item/seeds/tower,/obj/item/seeds/watermelon,/obj/item/seeds/wheat,/obj/effect/turf_decal/tile/green,/obj/effect/turf_decal/tile/green{dir = 1},/turf/open/floor/plasteel,/area/ruin/powered)
"V" = (/obj/machinery/hydroponics/constructable,/obj/effect/turf_decal/tile/green,/obj/effect/turf_decal/tile/green{dir = 1},/turf/open/floor/plasteel,/area/ruin/powered)

(1,1,1) = {"
ayaaaaaya
yyyyyyyyy
ayltLonya
yyswwwwyy
yVwCBNwVy
yVwwwwwVy
yVmDwDmVy
yyyyJyyyy
ayaaaaaya
"}
