//MAP CONVERTED BY dmm2tgm.py THIS HEADER COMMENT PREVENTS RECONVERSION, DO NOT REMOVE
"a" = (
/turf/closed/wall/mineral/titanium,
/area/ruin/powered)
"b" = (
/obj/effect/turf_decal/tile/blue,
/obj/effect/turf_decal/tile/blue{
	dir = 1
	},
/obj/machinery/light{
	dir = 8
	},
/turf/open/floor/plasteel/showroomfloor,
/area/ruin/powered)
"c" = (
/turf/template_noop,
/area/template_noop)
"d" = (
/obj/structure/chair/comfy/teal,
/turf/open/floor/carpet/blue,
/area/ruin/powered)
"e" = (
/obj/structure/closet/secure_closet/medical3,
/obj/effect/turf_decal/tile/blue,
/obj/effect/turf_decal/tile/blue{
	dir = 1
	},
/turf/open/floor/plasteel/showroomfloor,
/area/ruin/powered)
"f" = (
/obj/effect/turf_decal/tile/blue,
/obj/effect/turf_decal/tile/blue{
	dir = 1
	},
/obj/machinery/light{
	dir = 4
	},
/turf/open/floor/plasteel/showroomfloor,
/area/ruin/powered)
"g" = (
/obj/machinery/stasis,
/obj/effect/turf_decal/tile/blue,
/obj/effect/turf_decal/tile/blue{
	dir = 1
	},
/turf/open/floor/plasteel/showroomfloor,
/area/ruin/powered)
"h" = (
/obj/structure/sign/departments/medbay,
/turf/closed/wall/mineral/titanium,
/area/ruin/powered)
"i" = (
/obj/effect/turf_decal/tile/blue{
	dir = 1
	},
/obj/effect/turf_decal/tile/blue,
/turf/open/floor/plasteel/showroomfloor,
/area/ruin/powered)
"j" = (
/obj/structure/chair/comfy/teal{
	dir = 8
	},
/obj/effect/turf_decal/tile/blue,
/obj/effect/turf_decal/tile/blue{
	dir = 1
	},
/turf/open/floor/plasteel/showroomfloor,
/area/ruin/powered)
"k" = (
/obj/effect/turf_decal/tile/blue,
/obj/effect/turf_decal/tile/blue{
	dir = 1
	},
/turf/open/floor/plasteel/showroomfloor,
/area/ruin/powered)
"m" = (
/obj/machinery/computer/operating{
	dir = 4
	},
/obj/effect/turf_decal/tile/blue,
/obj/effect/turf_decal/tile/blue{
	dir = 1
	},
/turf/open/floor/plasteel/showroomfloor,
/area/ruin/powered)
"n" = (
/obj/structure/window{
	dir = 8
	},
/obj/machinery/computer/pandemic,
/obj/effect/turf_decal/tile/blue,
/obj/effect/turf_decal/tile/blue{
	dir = 1
	},
/turf/open/floor/plasteel/showroomfloor,
/area/ruin/powered)
"p" = (
/obj/effect/turf_decal/tile/blue,
/obj/effect/turf_decal/tile/blue{
	dir = 1
	},
/obj/structure/window{
	color = "#316a8e";
	dir = 1
	},
/turf/open/floor/plasteel/showroomfloor,
/area/ruin/powered)
"t" = (
/obj/structure/window{
	color = "#316a8e";
	dir = 1
	},
/turf/open/floor/carpet/blue,
/area/ruin/powered)
"w" = (
/obj/structure/closet/crate/medical,
/obj/effect/turf_decal/tile/blue,
/obj/effect/turf_decal/tile/blue{
	dir = 1
	},
/obj/item/soap/nanotrasen,
/mob/living/simple_animal/mouse{
	desc = "A rodent on the run, fleeing probably from another CMO's cat. How long has he been stuck on this new home ?";
	name = "Peter"
	},
/turf/open/floor/plasteel/showroomfloor,
/area/ruin/powered)
"x" = (
/obj/structure/table/optable,
/obj/item/storage/backpack/duffelbag/med/surgery,
/obj/effect/turf_decal/tile/blue,
/obj/effect/turf_decal/tile/blue{
	dir = 1
	},
/turf/open/floor/plasteel/showroomfloor,
/area/ruin/powered)
"y" = (
/obj/structure/sign/departments/medbay/alt,
/turf/closed/wall/mineral/titanium,
/area/ruin/powered)
"z" = (
/obj/structure/window{
	color = "#316a8e";
	dir = 8
	},
/obj/structure/bookcase/manuals,
/obj/structure/window{
	color = "#316a8e";
	dir = 1
	},
/turf/open/floor/carpet/blue,
/area/ruin/powered)
"A" = (
/obj/structure/table/glass,
/obj/item/food/salad/aesirsalad,
/obj/item/food/salad/jungle{
	pixel_x = 1;
	pixel_y = 13
	},
/turf/open/floor/carpet/blue,
/area/ruin/powered)
"B" = (
/obj/effect/turf_decal/tile/blue,
/obj/effect/turf_decal/tile/blue{
	dir = 1
	},
/obj/machinery/light,
/obj/structure/closet/secure_closet/personal/patient,
/turf/open/floor/plasteel/showroomfloor,
/area/ruin/powered)
"C" = (
/obj/effect/turf_decal/tile/blue,
/obj/effect/turf_decal/tile/blue{
	dir = 1
	},
/obj/structure/closet/secure_closet/personal/patient,
/turf/open/floor/plasteel/showroomfloor,
/area/ruin/powered)
"D" = (
/obj/structure/closet/crate/freezer/blood,
/obj/machinery/iv_drip,
/obj/effect/turf_decal/tile/blue,
/obj/effect/turf_decal/tile/blue{
	dir = 1
	},
/obj/machinery/light{
	dir = 1
	},
/turf/open/floor/plasteel/showroomfloor,
/area/ruin/powered)
"G" = (
/obj/structure/curtain/cloth{
	color = "#316a8e"
	},
/turf/open/floor/carpet/blue,
/area/ruin/powered)
"H" = (
/obj/structure/sign/warning/biohazard,
/turf/closed/wall/mineral/titanium,
/area/ruin/powered)
"J" = (
/obj/structure/window{
	color = "#316a8e";
	dir = 4
	},
/obj/structure/bed/roller,
/obj/item/bedsheet/medical,
/obj/effect/turf_decal/tile/blue,
/obj/effect/turf_decal/tile/blue{
	dir = 1
	},
/turf/open/floor/plasteel/showroomfloor,
/area/ruin/powered)
"K" = (
/obj/structure/window{
	dir = 8
	},
/obj/structure/window,
/obj/structure/table/glass,
/obj/item/reagent_containers/syringe/antiviral,
/obj/effect/turf_decal/tile/blue,
/obj/effect/turf_decal/tile/blue{
	dir = 1
	},
/turf/open/floor/plasteel/showroomfloor,
/area/ruin/powered)
"L" = (
/obj/structure/curtain/cloth{
	color = "#316a8e"
	},
/obj/effect/turf_decal/tile/blue,
/obj/effect/turf_decal/tile/blue{
	dir = 1
	},
/turf/open/floor/plasteel/showroomfloor,
/area/ruin/powered)
"O" = (
/obj/structure/closet/secure_closet/medical2,
/obj/effect/turf_decal/tile/blue,
/obj/effect/turf_decal/tile/blue{
	dir = 1
	},
/turf/open/floor/plasteel/showroomfloor,
/area/ruin/powered)
"Q" = (
/obj/machinery/light,
/obj/structure/table/glass,
/obj/item/food/salad/citrusdelight{
	pixel_y = 13
	},
/obj/item/food/salad/herbsalad,
/turf/open/floor/carpet/blue,
/area/ruin/powered)
"R" = (
/obj/structure/table/glass,
/obj/item/storage/box/donkpockets{
	pixel_x = 3;
	pixel_y = 5
	},
/obj/structure/window{
	color = "#316a8e";
	dir = 8
	},
/turf/open/floor/carpet/blue,
/area/ruin/powered)
"S" = (
/obj/structure/closet/wardrobe/white/medical,
/obj/effect/turf_decal/tile/blue,
/obj/effect/turf_decal/tile/blue{
	dir = 1
	},
/obj/item/storage/box/masks,
/obj/item/storage/box/gloves,
/turf/open/floor/plasteel/showroomfloor,
/area/ruin/powered)
"T" = (
/obj/machinery/medical_kiosk,
/obj/effect/turf_decal/tile/blue,
/obj/effect/turf_decal/tile/blue{
	dir = 1
	},
/obj/effect/turf_decal/box/white{
	color = "#52B4E9"
	},
/turf/open/floor/plasteel/showroomfloor,
/area/ruin/powered)
"U" = (
/obj/machinery/door/airlock/medical,
/obj/structure/fans/tiny,
/turf/open/floor/plasteel/showroomfloor,
/area/ruin/powered)
"X" = (
/obj/structure/bed/roller,
/obj/item/bedsheet/medical,
/obj/effect/turf_decal/tile/blue,
/obj/effect/turf_decal/tile/blue{
	dir = 1
	},
/obj/structure/window{
	color = "#316a8e";
	dir = 1
	},
/obj/structure/window{
	color = "#316a8e";
	dir = 4
	},
/turf/open/floor/plasteel/showroomfloor,
/area/ruin/powered)
"Y" = (
/obj/structure/closet/secure_closet/medical1,
/obj/effect/turf_decal/tile/blue{
	dir = 1
	},
/turf/open/floor/plasteel/showroomfloor,
/area/ruin/powered)
"Z" = (
/obj/machinery/defibrillator_mount,
/turf/closed/wall/mineral/titanium,
/area/ruin/powered)

(1,1,1) = {"
c
c
a
a
y
a
a
a
a
"}
(2,1,1) = {"
a
a
a
w
b
L
i
C
a
"}
(3,1,1) = {"
h
x
m
e
k
p
k
B
a
"}
(4,1,1) = {"
Z
j
k
k
k
X
J
a
a
"}
(5,1,1) = {"
a
D
O
T
k
k
k
U
c
"}
(6,1,1) = {"
a
n
K
Y
k
z
R
a
a
"}
(7,1,1) = {"
H
g
k
k
k
t
d
Q
a
"}
(8,1,1) = {"
a
a
a
S
f
G
d
A
a
"}
(9,1,1) = {"
c
c
a
a
y
a
a
a
a
"}
