//MAP CONVERTED BY dmm2tgm.py THIS HEADER COMMENT PREVENTS RECONVERSION, DO NOT REMOVE
"a" = (
/turf/template_noop,
/area/template_noop)
"d" = (
/obj/machinery/chem_dispenser,
/obj/effect/turf_decal/siding/blue{
	dir = 5
	},
/obj/effect/turf_decal/tile/yellow{
	color = "#FF7400"
	},
/obj/effect/turf_decal/tile/yellow{
	color = "#FF7400"
	},
/obj/effect/turf_decal/tile/yellow{
	color = "#FF7400";
	dir = 1
	},
/obj/effect/turf_decal/tile/yellow{
	color = "#FF7400";
	dir = 1
	},
/obj/effect/turf_decal/tile{
	dir = 4
	},
/obj/effect/turf_decal/tile{
	dir = 8
	},
/turf/open/floor/plasteel,
/area/ruin/powered)
"g" = (
/obj/machinery/chem_master,
/obj/effect/turf_decal/siding/blue{
	dir = 1
	},
/obj/effect/turf_decal/tile/yellow{
	color = "#FF7400"
	},
/obj/effect/turf_decal/tile/yellow{
	color = "#FF7400"
	},
/obj/effect/turf_decal/tile/yellow{
	color = "#FF7400";
	dir = 1
	},
/obj/effect/turf_decal/tile/yellow{
	color = "#FF7400";
	dir = 1
	},
/obj/effect/turf_decal/tile{
	dir = 4
	},
/obj/effect/turf_decal/tile{
	dir = 8
	},
/turf/open/floor/plasteel,
/area/ruin/powered)
"i" = (
/obj/effect/turf_decal/tile{
	dir = 4
	},
/obj/effect/turf_decal/tile{
	dir = 8
	},
/obj/effect/turf_decal/tile/yellow{
	color = "#FF7400";
	dir = 1
	},
/obj/effect/turf_decal/tile/yellow{
	color = "#FF7400";
	dir = 1
	},
/obj/effect/turf_decal/tile/yellow{
	color = "#FF7400"
	},
/obj/effect/turf_decal/tile/yellow{
	color = "#FF7400"
	},
/obj/effect/turf_decal/siding/blue{
	dir = 6
	},
/turf/closed/wall/mineral/titanium,
/area/ruin/powered)
"k" = (
/obj/structure/table/glass,
/obj/item/assembly/igniter{
	pixel_x = 13;
	pixel_y = 9
	},
/obj/item/assembly/timer{
	pixel_x = -12;
	pixel_y = 11
	},
/obj/machinery/reagentgrinder,
/obj/effect/turf_decal/siding/blue{
	dir = 4
	},
/obj/effect/turf_decal/tile/yellow{
	color = "#FF7400"
	},
/obj/effect/turf_decal/tile/yellow{
	color = "#FF7400"
	},
/obj/effect/turf_decal/tile/yellow{
	color = "#FF7400";
	dir = 1
	},
/obj/effect/turf_decal/tile/yellow{
	color = "#FF7400";
	dir = 1
	},
/obj/effect/turf_decal/tile{
	dir = 4
	},
/obj/effect/turf_decal/tile{
	dir = 8
	},
/turf/open/floor/plasteel,
/area/ruin/powered)
"m" = (
/obj/structure/table/glass,
/obj/item/assembly/igniter{
	pixel_x = -9;
	pixel_y = 11
	},
/obj/item/assembly/timer{
	pixel_x = 12;
	pixel_y = 11
	},
/obj/machinery/reagentgrinder,
/obj/effect/turf_decal/siding/blue{
	dir = 8
	},
/obj/effect/turf_decal/tile/yellow{
	color = "#FF7400"
	},
/obj/effect/turf_decal/tile/yellow{
	color = "#FF7400"
	},
/obj/effect/turf_decal/tile/yellow{
	color = "#FF7400";
	dir = 1
	},
/obj/effect/turf_decal/tile/yellow{
	color = "#FF7400";
	dir = 1
	},
/obj/effect/turf_decal/tile{
	dir = 4
	},
/obj/effect/turf_decal/tile{
	dir = 8
	},
/turf/open/floor/plasteel,
/area/ruin/powered)
"o" = (
/obj/effect/turf_decal/tile/yellow{
	color = "#FF7400"
	},
/obj/effect/turf_decal/tile/yellow{
	color = "#FF7400"
	},
/obj/effect/turf_decal/tile/yellow{
	color = "#FF7400";
	dir = 1
	},
/obj/effect/turf_decal/tile/yellow{
	color = "#FF7400";
	dir = 1
	},
/obj/effect/turf_decal/tile{
	dir = 4
	},
/obj/effect/turf_decal/tile{
	dir = 8
	},
/obj/structure/closet/secure_closet/chemical,
/obj/item/storage/box/syringes,
/obj/item/storage/box/syringes,
/obj/item/storage/box/beakers,
/obj/item/storage/box/beakers,
/obj/effect/turf_decal/siding/blue{
	dir = 4
	},
/turf/open/floor/plasteel,
/area/ruin/powered)
"p" = (
/obj/structure/sign/departments/chemistry,
/turf/closed/wall/mineral/titanium,
/area/ruin/powered)
"q" = (
/obj/effect/turf_decal/tile/yellow{
	color = "#FF7400"
	},
/obj/effect/turf_decal/tile/yellow{
	color = "#FF7400"
	},
/obj/effect/turf_decal/tile/yellow{
	color = "#FF7400";
	dir = 1
	},
/obj/effect/turf_decal/tile/yellow{
	color = "#FF7400";
	dir = 1
	},
/obj/effect/turf_decal/tile{
	dir = 4
	},
/obj/effect/turf_decal/tile{
	dir = 8
	},
/obj/machinery/vending/wardrobe/chem_wardrobe,
/obj/effect/turf_decal/siding/blue/corner{
	dir = 8
	},
/turf/open/floor/plasteel,
/area/ruin/powered)
"t" = (
/obj/effect/turf_decal/tile/yellow{
	color = "#FF7400"
	},
/obj/effect/turf_decal/tile/yellow{
	color = "#FF7400"
	},
/obj/effect/turf_decal/tile/yellow{
	color = "#FF7400";
	dir = 1
	},
/obj/effect/turf_decal/tile/yellow{
	color = "#FF7400";
	dir = 1
	},
/obj/effect/turf_decal/tile{
	dir = 4
	},
/obj/effect/turf_decal/tile{
	dir = 8
	},
/obj/structure/fans/tiny,
/obj/structure/table/reinforced,
/obj/machinery/door/window{
	dir = 4
	},
/obj/machinery/door/window{
	dir = 8
	},
/obj/effect/turf_decal/siding/blue/end{
	dir = 8
	},
/turf/open/floor/plasteel,
/area/ruin/powered)
"u" = (
/obj/effect/turf_decal/tile{
	dir = 4
	},
/obj/effect/turf_decal/tile{
	dir = 8
	},
/obj/effect/turf_decal/tile/yellow{
	color = "#FF7400";
	dir = 1
	},
/obj/effect/turf_decal/tile/yellow{
	color = "#FF7400";
	dir = 1
	},
/obj/effect/turf_decal/tile/yellow{
	color = "#FF7400"
	},
/obj/effect/turf_decal/tile/yellow{
	color = "#FF7400"
	},
/obj/effect/turf_decal/siding/blue{
	dir = 6
	},
/turf/closed/wall/mineral/titanium/interior,
/area/ruin/powered)
"y" = (
/obj/structure/fans/tiny,
/obj/machinery/door/airlock/public/glass,
/obj/effect/turf_decal/siding/blue/end,
/obj/effect/turf_decal/tile/yellow{
	color = "#FF7400"
	},
/obj/effect/turf_decal/tile/yellow{
	color = "#FF7400"
	},
/obj/effect/turf_decal/tile/yellow{
	color = "#FF7400";
	dir = 1
	},
/obj/effect/turf_decal/tile/yellow{
	color = "#FF7400";
	dir = 1
	},
/obj/effect/turf_decal/tile{
	dir = 4
	},
/obj/effect/turf_decal/tile{
	dir = 8
	},
/turf/open/floor/plasteel,
/area/ruin/powered)
"z" = (
/obj/structure/table,
/obj/item/storage/box/beakers{
	pixel_x = 6;
	pixel_y = 9
	},
/obj/item/reagent_containers/glass/beaker/large{
	pixel_x = -6;
	pixel_y = 4
	},
/obj/effect/turf_decal/tile/yellow{
	color = "#FF7400"
	},
/obj/effect/turf_decal/tile/yellow{
	color = "#FF7400"
	},
/obj/effect/turf_decal/tile/yellow{
	color = "#FF7400";
	dir = 1
	},
/obj/effect/turf_decal/tile/yellow{
	color = "#FF7400";
	dir = 1
	},
/obj/effect/turf_decal/tile{
	dir = 4
	},
/obj/effect/turf_decal/tile{
	dir = 8
	},
/obj/item/reagent_containers/dropper,
/turf/open/floor/plasteel,
/area/ruin/powered)
"B" = (
/obj/effect/turf_decal/tile{
	dir = 8
	},
/obj/effect/turf_decal/tile{
	dir = 4
	},
/obj/effect/turf_decal/tile/yellow{
	color = "#FF7400";
	dir = 1
	},
/obj/effect/turf_decal/tile/yellow{
	color = "#FF7400";
	dir = 1
	},
/obj/effect/turf_decal/tile/yellow{
	color = "#FF7400"
	},
/obj/effect/turf_decal/tile/yellow{
	color = "#FF7400"
	},
/obj/effect/turf_decal/siding/blue{
	dir = 10
	},
/turf/closed/wall/mineral/titanium,
/area/ruin/powered)
"G" = (
/obj/structure/table,
/obj/item/stack/cable_coil{
	pixel_x = -9;
	pixel_y = 9
	},
/obj/item/stack/cable_coil{
	pixel_x = 9;
	pixel_y = 9
	},
/obj/item/grenade/chem_grenade{
	pixel_x = -7;
	pixel_y = 4
	},
/obj/item/grenade/chem_grenade{
	pixel_x = -7
	},
/obj/item/grenade/chem_grenade{
	pixel_x = 9;
	pixel_y = 4
	},
/obj/item/grenade/chem_grenade{
	pixel_x = 9
	},
/obj/item/screwdriver{
	pixel_x = 3;
	pixel_y = 12
	},
/obj/item/screwdriver{
	pixel_x = 3;
	pixel_y = 4
	},
/obj/effect/turf_decal/siding/blue{
	dir = 1
	},
/obj/effect/turf_decal/tile/yellow{
	color = "#FF7400"
	},
/obj/effect/turf_decal/tile/yellow{
	color = "#FF7400"
	},
/obj/effect/turf_decal/tile/yellow{
	color = "#FF7400";
	dir = 1
	},
/obj/effect/turf_decal/tile/yellow{
	color = "#FF7400";
	dir = 1
	},
/obj/effect/turf_decal/tile{
	dir = 4
	},
/obj/effect/turf_decal/tile{
	dir = 8
	},
/turf/open/floor/plasteel,
/area/ruin/powered)
"H" = (
/obj/effect/turf_decal/tile/yellow{
	color = "#FF7400"
	},
/obj/effect/turf_decal/tile/yellow{
	color = "#FF7400"
	},
/obj/effect/turf_decal/tile/yellow{
	color = "#FF7400";
	dir = 1
	},
/obj/effect/turf_decal/tile/yellow{
	color = "#FF7400";
	dir = 1
	},
/obj/effect/turf_decal/tile{
	dir = 4
	},
/obj/effect/turf_decal/tile{
	dir = 8
	},
/obj/effect/turf_decal/siding/blue/corner{
	dir = 4
	},
/obj/effect/turf_decal/siding/blue/corner,
/turf/open/floor/plasteel,
/area/ruin/powered)
"I" = (
/obj/machinery/chem_master,
/obj/effect/turf_decal/siding/blue{
	dir = 9
	},
/obj/effect/turf_decal/tile/yellow{
	color = "#FF7400"
	},
/obj/effect/turf_decal/tile/yellow{
	color = "#FF7400"
	},
/obj/effect/turf_decal/tile/yellow{
	color = "#FF7400";
	dir = 1
	},
/obj/effect/turf_decal/tile/yellow{
	color = "#FF7400";
	dir = 1
	},
/obj/effect/turf_decal/tile{
	dir = 4
	},
/obj/effect/turf_decal/tile{
	dir = 8
	},
/turf/open/floor/plasteel,
/area/ruin/powered)
"J" = (
/obj/machinery/chem_heater,
/obj/machinery/light{
	dir = 4
	},
/obj/effect/turf_decal/siding/blue{
	dir = 4
	},
/obj/effect/turf_decal/tile/yellow{
	color = "#FF7400"
	},
/obj/effect/turf_decal/tile/yellow{
	color = "#FF7400"
	},
/obj/effect/turf_decal/tile/yellow{
	color = "#FF7400";
	dir = 1
	},
/obj/effect/turf_decal/tile/yellow{
	color = "#FF7400";
	dir = 1
	},
/obj/effect/turf_decal/tile{
	dir = 4
	},
/obj/effect/turf_decal/tile{
	dir = 8
	},
/turf/open/floor/plasteel,
/area/ruin/powered)
"K" = (
/obj/machinery/chem_dispenser,
/obj/effect/turf_decal/siding/blue{
	dir = 1
	},
/obj/effect/turf_decal/tile/yellow{
	color = "#FF7400"
	},
/obj/effect/turf_decal/tile/yellow{
	color = "#FF7400"
	},
/obj/effect/turf_decal/tile/yellow{
	color = "#FF7400";
	dir = 1
	},
/obj/effect/turf_decal/tile/yellow{
	color = "#FF7400";
	dir = 1
	},
/obj/effect/turf_decal/tile{
	dir = 4
	},
/obj/effect/turf_decal/tile{
	dir = 8
	},
/turf/open/floor/plasteel,
/area/ruin/powered)
"L" = (
/turf/closed/wall/mineral/titanium,
/area/ruin/powered)
"N" = (
/obj/effect/turf_decal/tile/yellow{
	color = "#FF7400"
	},
/obj/effect/turf_decal/tile/yellow{
	color = "#FF7400"
	},
/obj/effect/turf_decal/tile/yellow{
	color = "#FF7400";
	dir = 1
	},
/obj/effect/turf_decal/tile/yellow{
	color = "#FF7400";
	dir = 1
	},
/obj/effect/turf_decal/tile{
	dir = 4
	},
/obj/effect/turf_decal/tile{
	dir = 8
	},
/turf/open/floor/plasteel,
/area/ruin/powered)
"P" = (
/obj/structure/table,
/obj/item/storage/box/beakers{
	pixel_x = -6;
	pixel_y = 9
	},
/obj/item/reagent_containers/glass/beaker/large{
	pixel_x = 6;
	pixel_y = 5
	},
/obj/effect/turf_decal/tile/yellow{
	color = "#FF7400"
	},
/obj/effect/turf_decal/tile/yellow{
	color = "#FF7400"
	},
/obj/effect/turf_decal/tile/yellow{
	color = "#FF7400";
	dir = 1
	},
/obj/effect/turf_decal/tile/yellow{
	color = "#FF7400";
	dir = 1
	},
/obj/effect/turf_decal/tile{
	dir = 4
	},
/obj/effect/turf_decal/tile{
	dir = 8
	},
/obj/item/reagent_containers/dropper,
/turf/open/floor/plasteel,
/area/ruin/powered)
"Q" = (
/obj/effect/turf_decal/tile/yellow{
	color = "#FF7400"
	},
/obj/effect/turf_decal/tile/yellow{
	color = "#FF7400"
	},
/obj/effect/turf_decal/tile/yellow{
	color = "#FF7400";
	dir = 1
	},
/obj/effect/turf_decal/tile/yellow{
	color = "#FF7400";
	dir = 1
	},
/obj/effect/turf_decal/tile{
	dir = 4
	},
/obj/effect/turf_decal/tile{
	dir = 8
	},
/obj/effect/turf_decal/siding/blue/corner{
	dir = 8
	},
/obj/effect/turf_decal/siding/blue/corner{
	dir = 1
	},
/turf/open/floor/plasteel,
/area/ruin/powered)
"R" = (
/obj/machinery/chem_heater,
/obj/machinery/light{
	dir = 8
	},
/obj/effect/turf_decal/siding/blue{
	dir = 8
	},
/obj/effect/turf_decal/tile/yellow{
	color = "#FF7400"
	},
/obj/effect/turf_decal/tile/yellow{
	color = "#FF7400"
	},
/obj/effect/turf_decal/tile/yellow{
	color = "#FF7400";
	dir = 1
	},
/obj/effect/turf_decal/tile/yellow{
	color = "#FF7400";
	dir = 1
	},
/obj/effect/turf_decal/tile{
	dir = 4
	},
/obj/effect/turf_decal/tile{
	dir = 8
	},
/turf/open/floor/plasteel,
/area/ruin/powered)
"S" = (
/obj/effect/turf_decal/tile/yellow{
	color = "#FF7400"
	},
/obj/effect/turf_decal/tile/yellow{
	color = "#FF7400"
	},
/obj/effect/turf_decal/tile/yellow{
	color = "#FF7400";
	dir = 1
	},
/obj/effect/turf_decal/tile/yellow{
	color = "#FF7400";
	dir = 1
	},
/obj/effect/turf_decal/tile{
	dir = 4
	},
/obj/effect/turf_decal/tile{
	dir = 8
	},
/obj/structure/fans/tiny,
/obj/structure/table/reinforced,
/obj/machinery/door/window{
	dir = 4
	},
/obj/machinery/door/window{
	dir = 8
	},
/obj/effect/turf_decal/siding/blue/end{
	dir = 4
	},
/turf/open/floor/plasteel,
/area/ruin/powered)
"U" = (
/obj/effect/turf_decal/tile/yellow{
	color = "#FF7400"
	},
/obj/effect/turf_decal/tile/yellow{
	color = "#FF7400";
	dir = 1
	},
/obj/effect/turf_decal/tile/yellow{
	color = "#FF7400";
	dir = 1
	},
/obj/effect/turf_decal/tile/yellow{
	color = "#FF7400"
	},
/obj/effect/turf_decal/tile{
	dir = 4
	},
/obj/effect/turf_decal/tile{
	dir = 8
	},
/turf/open/floor/plasteel,
/area/ruin/powered)
"V" = (
/obj/effect/turf_decal/tile/yellow{
	color = "#FF7400"
	},
/obj/effect/turf_decal/tile/yellow{
	color = "#FF7400"
	},
/obj/effect/turf_decal/tile/yellow{
	color = "#FF7400";
	dir = 1
	},
/obj/effect/turf_decal/tile/yellow{
	color = "#FF7400";
	dir = 1
	},
/obj/effect/turf_decal/tile{
	dir = 4
	},
/obj/effect/turf_decal/tile{
	dir = 8
	},
/obj/effect/turf_decal/siding/blue/corner{
	dir = 8
	},
/obj/effect/turf_decal/siding/blue/corner,
/turf/open/floor/plasteel,
/area/ruin/powered)
"W" = (
/obj/effect/turf_decal/tile{
	dir = 8
	},
/obj/effect/turf_decal/tile{
	dir = 4
	},
/obj/effect/turf_decal/tile/yellow{
	color = "#FF7400";
	dir = 1
	},
/obj/effect/turf_decal/tile/yellow{
	color = "#FF7400";
	dir = 1
	},
/obj/effect/turf_decal/tile/yellow{
	color = "#FF7400"
	},
/obj/effect/turf_decal/siding/blue{
	dir = 10
	},
/turf/closed/wall/mineral/titanium/interior,
/area/ruin/powered)
"Y" = (
/obj/machinery/smartfridge/chemistry/preloaded,
/obj/effect/turf_decal/tile/yellow{
	color = "#FF7400"
	},
/obj/effect/turf_decal/tile/yellow{
	color = "#FF7400"
	},
/obj/effect/turf_decal/tile/yellow{
	color = "#FF7400";
	dir = 1
	},
/obj/effect/turf_decal/tile/yellow{
	color = "#FF7400";
	dir = 1
	},
/obj/effect/turf_decal/tile{
	dir = 4
	},
/obj/effect/turf_decal/tile{
	dir = 8
	},
/obj/effect/turf_decal/siding/blue{
	dir = 8
	},
/turf/open/floor/plasteel,
/area/ruin/powered)
"Z" = (
/obj/effect/turf_decal/tile/yellow{
	color = "#FF7400"
	},
/obj/effect/turf_decal/tile/yellow{
	color = "#FF7400"
	},
/obj/effect/turf_decal/tile/yellow{
	color = "#FF7400";
	dir = 1
	},
/obj/effect/turf_decal/tile/yellow{
	color = "#FF7400";
	dir = 1
	},
/obj/effect/turf_decal/tile{
	dir = 4
	},
/obj/effect/turf_decal/tile{
	dir = 8
	},
/obj/machinery/vending/drugs,
/obj/effect/turf_decal/siding/blue/corner,
/turf/open/floor/plasteel,
/area/ruin/powered)

(1,1,1) = {"
L
a
a
a
a
a
L
a
a
"}
(2,1,1) = {"
L
L
t
L
L
L
p
a
a
"}
(3,1,1) = {"
L
I
Q
R
m
Y
B
L
a
"}
(4,1,1) = {"
L
K
N
P
N
N
q
W
L
"}
(5,1,1) = {"
L
G
N
U
N
N
N
V
y
"}
(6,1,1) = {"
L
g
N
z
N
N
Z
u
L
"}
(7,1,1) = {"
L
d
H
J
k
o
i
L
a
"}
(8,1,1) = {"
L
L
S
L
L
L
p
a
a
"}
(9,1,1) = {"
L
a
a
a
a
a
L
a
a
"}
