"a" = (/turf/closed/wall/mineral/titanium,/area/medical/medbay)
"b" = (/obj/effect/turf_decal/tile/blue,/obj/effect/turf_decal/tile/blue{dir = 1},/obj/machinery/light{dir = 8},/turf/open/floor/plasteel/showroomfloor,/area/medical/medbay)
"c" = (/turf/template_noop,/area/template_noop)
"d" = (/obj/structure/chair/comfy/teal,/turf/open/floor/carpet/blue,/area/medical/medbay)
"e" = (/obj/structure/closet/secure_closet/medical3,/obj/effect/turf_decal/tile/blue,/obj/effect/turf_decal/tile/blue{dir = 1},/turf/open/floor/plasteel/showroomfloor,/area/medical/medbay)
"f" = (/obj/effect/turf_decal/tile/blue,/obj/effect/turf_decal/tile/blue{dir = 1},/obj/machinery/light{dir = 4},/turf/open/floor/plasteel/showroomfloor,/area/medical/medbay)
"g" = (/obj/machinery/stasis,/obj/effect/turf_decal/tile/blue,/obj/effect/turf_decal/tile/blue{dir = 1},/turf/open/floor/plasteel/showroomfloor,/area/medical/medbay)
"h" = (/obj/structure/sign/departments/medbay,/turf/closed/wall/mineral/titanium,/area/medical/medbay)
"i" = (/obj/effect/turf_decal/tile/blue{dir = 1},/obj/effect/turf_decal/tile/blue,/turf/open/floor/plasteel/showroomfloor,/area/medical/medbay)
"j" = (/obj/structure/chair/comfy/teal{dir = 8},/obj/effect/turf_decal/tile/blue,/obj/effect/turf_decal/tile/blue{dir = 1},/turf/open/floor/plasteel/showroomfloor,/area/medical/medbay)
"k" = (/obj/effect/turf_decal/tile/blue,/obj/effect/turf_decal/tile/blue{dir = 1},/turf/open/floor/plasteel/showroomfloor,/area/medical/medbay)
"m" = (/obj/machinery/computer/operating{dir = 4},/obj/effect/turf_decal/tile/blue,/obj/effect/turf_decal/tile/blue{dir = 1},/turf/open/floor/plasteel/showroomfloor,/area/medical/medbay)
"n" = (/obj/structure/window{dir = 8},/obj/machinery/computer/pandemic,/obj/effect/turf_decal/tile/blue,/obj/effect/turf_decal/tile/blue{dir = 1},/turf/open/floor/plasteel/showroomfloor,/area/medical/medbay)
"p" = (/obj/effect/turf_decal/tile/blue,/obj/effect/turf_decal/tile/blue{dir = 1},/obj/structure/window{color = "#316a8e"; dir = 1},/turf/open/floor/plasteel/showroomfloor,/area/medical/medbay)
"t" = (/obj/structure/window{color = "#316a8e"; dir = 1},/turf/open/floor/carpet/blue,/area/medical/medbay)
"w" = (/obj/structure/closet/crate/medical,/obj/effect/turf_decal/tile/blue,/obj/effect/turf_decal/tile/blue{dir = 1},/obj/item/soap/nanotrasen,/mob/living/simple_animal/mouse{desc = "A rodent on the run, fleeing probably from another CMO's cat. How long has he been stuck on this new home ?"; name = "Peter"},/turf/open/floor/plasteel/showroomfloor,/area/medical/medbay)
"x" = (/obj/structure/table/optable,/obj/item/storage/backpack/duffelbag/med/surgery,/obj/effect/turf_decal/tile/blue,/obj/effect/turf_decal/tile/blue{dir = 1},/turf/open/floor/plasteel/showroomfloor,/area/medical/medbay)
"y" = (/obj/structure/sign/departments/medbay/alt,/turf/closed/wall/mineral/titanium,/area/medical/medbay)
"z" = (/obj/structure/window{color = "#316a8e"; dir = 8},/obj/structure/bookcase/manuals,/obj/structure/window{color = "#316a8e"; dir = 1},/turf/open/floor/carpet/blue,/area/medical/medbay)
"A" = (/obj/structure/table/glass,/obj/item/food/salad/aesirsalad,/obj/item/food/salad/jungle{pixel_x = 1; pixel_y = 13},/turf/open/floor/carpet/blue,/area/medical/medbay)
"B" = (/obj/effect/turf_decal/tile/blue,/obj/effect/turf_decal/tile/blue{dir = 1},/obj/machinery/light,/obj/structure/closet/secure_closet/personal/patient,/turf/open/floor/plasteel/showroomfloor,/area/medical/medbay)
"C" = (/obj/effect/turf_decal/tile/blue,/obj/effect/turf_decal/tile/blue{dir = 1},/obj/structure/closet/secure_closet/personal/patient,/turf/open/floor/plasteel/showroomfloor,/area/medical/medbay)
"D" = (/obj/structure/closet/crate/freezer/blood,/obj/machinery/iv_drip,/obj/effect/turf_decal/tile/blue,/obj/effect/turf_decal/tile/blue{dir = 1},/obj/machinery/light{dir = 1},/turf/open/floor/plasteel/showroomfloor,/area/medical/medbay)
"G" = (/obj/structure/curtain/cloth{color = "#316a8e"},/turf/open/floor/carpet/blue,/area/medical/medbay)
"H" = (/obj/structure/sign/warning/biohazard,/turf/closed/wall/mineral/titanium,/area/medical/medbay)
"J" = (/obj/structure/window{color = "#316a8e"; dir = 4},/obj/structure/bed/roller,/obj/item/bedsheet/medical,/obj/effect/turf_decal/tile/blue,/obj/effect/turf_decal/tile/blue{dir = 1},/turf/open/floor/plasteel/showroomfloor,/area/medical/medbay)
"K" = (/obj/structure/window{dir = 8},/obj/structure/window,/obj/structure/table/glass,/obj/item/reagent_containers/syringe/antiviral,/obj/effect/turf_decal/tile/blue,/obj/effect/turf_decal/tile/blue{dir = 1},/turf/open/floor/plasteel/showroomfloor,/area/medical/medbay)
"L" = (/obj/structure/curtain/cloth{color = "#316a8e"},/obj/effect/turf_decal/tile/blue,/obj/effect/turf_decal/tile/blue{dir = 1},/turf/open/floor/plasteel/showroomfloor,/area/medical/medbay)
"O" = (/obj/structure/closet/secure_closet/medical2,/obj/effect/turf_decal/tile/blue,/obj/effect/turf_decal/tile/blue{dir = 1},/turf/open/floor/plasteel/showroomfloor,/area/medical/medbay)
"Q" = (/obj/machinery/light,/obj/structure/table/glass,/obj/item/food/salad/citrusdelight{pixel_y = 13},/obj/item/food/salad/herbsalad,/turf/open/floor/carpet/blue,/area/medical/medbay)
"R" = (/obj/structure/table/glass,/obj/item/storage/box/donkpockets{pixel_x = 3; pixel_y = 5},/obj/structure/window{color = "#316a8e"; dir = 8},/turf/open/floor/carpet/blue,/area/medical/medbay)
"S" = (/obj/structure/closet/wardrobe/white/medical,/obj/effect/turf_decal/tile/blue,/obj/effect/turf_decal/tile/blue{dir = 1},/obj/item/storage/box/masks,/obj/item/storage/box/gloves,/turf/open/floor/plasteel/showroomfloor,/area/medical/medbay)
"T" = (/obj/machinery/medical_kiosk,/obj/effect/turf_decal/tile/blue,/obj/effect/turf_decal/tile/blue{dir = 1},/obj/effect/turf_decal/box/white{color = "#52B4E9"},/turf/open/floor/plasteel/showroomfloor,/area/medical/medbay)
"U" = (/obj/machinery/door/airlock/medical,/obj/structure/fans/tiny,/turf/open/floor/plasteel/showroomfloor,/area/medical/medbay)
"X" = (/obj/structure/bed/roller,/obj/item/bedsheet/medical,/obj/effect/turf_decal/tile/blue,/obj/effect/turf_decal/tile/blue{dir = 1},/obj/structure/window{color = "#316a8e"; dir = 1},/obj/structure/window{color = "#316a8e"; dir = 4},/turf/open/floor/plasteel/showroomfloor,/area/medical/medbay)
"Y" = (/obj/structure/closet/secure_closet/medical1,/obj/effect/turf_decal/tile/blue{dir = 1},/turf/open/floor/plasteel/showroomfloor,/area/medical/medbay)
"Z" = (/obj/machinery/defibrillator_mount,/turf/closed/wall/mineral/titanium,/area/medical/medbay)

(1,1,1) = {"
cahZaaHac
caxjDngac
aamkOKkaa
awekTYkSa
ybkkkkkfy
aLpXkztGa
aikJkRdda
aCBaUaQAa
aaaacaaaa
"}
