//MAP CONVERTED BY dmm2tgm.py THIS HEADER COMMENT PREVENTS RECONVERSION, DO NOT REMOVE
"a" = (
/turf/template_noop,
/area/template_noop)
"b" = (
/obj/structure/closet/secure_closet/engineering_electrical,
/turf/open/floor/plasteel/showroomfloor,
/area/ruin/space/has_grav/powered)
"c" = (
/obj/structure/closet/secure_closet/engineering_welding,
/turf/open/floor/plasteel/showroomfloor,
/area/ruin/space/has_grav/powered)
"d" = (
/obj/machinery/portable_atmospherics/canister/oxygen,
/turf/open/floor/plasteel/showroomfloor,
/area/ruin/space/has_grav/powered)
"e" = (
/obj/structure/closet/secure_closet/engineering_personal,
/obj/machinery/light,
/turf/open/floor/plasteel/showroomfloor,
/area/ruin/space/has_grav/powered)
"g" = (
/obj/machinery/portable_atmospherics/canister/carbon_dioxide,
/obj/structure/window{
	dir = 8
	},
/obj/structure/window{
	dir = 4
	},
/turf/open/floor/plasteel/showroomfloor,
/area/ruin/space/has_grav/powered)
"h" = (
/obj/machinery/vending/coffee,
/turf/open/floor/plasteel/showroomfloor,
/area/ruin/space/has_grav/powered)
"j" = (
/obj/machinery/suit_storage_unit/engine,
/turf/open/floor/plasteel/showroomfloor,
/area/ruin/space/has_grav/powered)
"l" = (
/obj/machinery/vending/engivend,
/turf/open/floor/plasteel/showroomfloor,
/area/ruin/space/has_grav/powered)
"n" = (
/obj/effect/spawner/structure/window/reinforced,
/turf/open/floor/plating,
/area/ruin/space/has_grav/powered)
"p" = (
/obj/machinery/vending/tool,
/obj/machinery/light,
/turf/open/floor/plasteel/showroomfloor,
/area/ruin/space/has_grav/powered)
"t" = (
/obj/machinery/suit_storage_unit/atmos,
/obj/machinery/light{
	dir = 1
	},
/turf/open/floor/plasteel/showroomfloor,
/area/ruin/space/has_grav/powered)
"u" = (
/obj/structure/closet/crate/engineering,
/obj/item/stack/sheet/metal/fifty,
/obj/item/stack/sheet/metal/fifty,
/obj/item/stack/sheet/glass/fifty,
/obj/item/stack/sheet/glass/fifty,
/obj/machinery/light,
/turf/open/floor/plasteel/showroomfloor,
/area/ruin/space/has_grav/powered)
"y" = (
/obj/structure/fans/tiny,
/obj/machinery/door/airlock/engineering/glass,
/turf/open/floor/plasteel/showroomfloor,
/area/ruin/space/has_grav/powered)
"A" = (
/obj/structure/closet/secure_closet/atmospherics,
/turf/open/floor/plasteel/showroomfloor,
/area/ruin/space/has_grav/powered)
"F" = (
/obj/structure/table/reinforced,
/obj/item/stack/sheet/metal/fifty,
/obj/item/stack/rods/fifty,
/turf/open/floor/plasteel/showroomfloor,
/area/ruin/space/has_grav/powered)
"G" = (
/obj/machinery/portable_atmospherics/canister/nitrogen,
/obj/machinery/light{
	dir = 1
	},
/turf/open/floor/plasteel/showroomfloor,
/area/ruin/space/has_grav/powered)
"I" = (
/obj/machinery/portable_atmospherics/canister/toxins,
/turf/open/floor/plasteel/showroomfloor,
/area/ruin/space/has_grav/powered)
"K" = (
/obj/machinery/portable_atmospherics/canister/nitrogen,
/obj/structure/window{
	dir = 4
	},
/obj/structure/window{
	dir = 8
	},
/turf/open/floor/plasteel/showroomfloor,
/area/ruin/space/has_grav/powered)
"L" = (
/turf/closed/wall/mineral/titanium,
/area/ruin/space/has_grav/powered)
"Q" = (
/obj/machinery/door/window{
	dir = 1
	},
/turf/open/floor/plasteel/showroomfloor,
/area/ruin/space/has_grav/powered)
"S" = (
/obj/structure/table/reinforced,
/obj/item/pipe_dispenser,
/obj/machinery/light{
	dir = 1
	},
/turf/open/floor/plasteel/showroomfloor,
/area/ruin/space/has_grav/powered)
"T" = (
/obj/machinery/autolathe,
/turf/open/floor/plasteel/showroomfloor,
/area/ruin/space/has_grav/powered)
"W" = (
/obj/structure/table/reinforced,
/obj/item/clothing/mask/gas/atmos,
/obj/item/clothing/gloves/color/black,
/obj/item/storage/belt/utility/full/engi,
/obj/machinery/light,
/turf/open/floor/plasteel/showroomfloor,
/area/ruin/space/has_grav/powered)
"Z" = (
/turf/open/floor/plasteel/showroomfloor,
/area/ruin/space/has_grav/powered)

(1,1,1) = {"
a
L
n
n
n
n
n
L
a
"}
(2,1,1) = {"
L
L
t
j
h
l
p
L
L
"}
(3,1,1) = {"
L
I
Q
Z
Z
Z
Z
F
L
"}
(4,1,1) = {"
L
K
Q
Z
Z
Z
Z
W
L
"}
(5,1,1) = {"
L
G
Q
Z
Z
Z
Z
Z
y
"}
(6,1,1) = {"
L
g
Q
Z
Z
Z
Z
u
L
"}
(7,1,1) = {"
L
d
Q
Z
Z
Z
Z
T
L
"}
(8,1,1) = {"
L
L
S
c
b
A
e
L
L
"}
(9,1,1) = {"
a
L
n
n
n
n
n
L
a
"}
