"cj" = (/obj/effect/turf_decal/weather/snow/corner{dir = 8},/turf/closed/wall/r_wall,/area/engine/storage)
"cC" = (/obj/effect/decal/cleanable/dirt,/obj/effect/decal/cleanable/blood/old,/turf/open/floor/plating,/area/engine/storage)
"dm" = (/obj/structure/rack,/obj/item/mecha_parts/mecha_equipment/weapon/energy/plasma,/obj/effect/decal/cleanable/cobweb,/obj/effect/decal/cleanable/dirt,/obj/effect/decal/fakelattice,/obj/item/mecha_parts/mecha_equipment/weapon/energy/laser/heavy,/obj/effect/spawner/lootdrop/tierweapon/ranged/tier1,/obj/effect/spawner/lootdrop/tierweapon/ranged/tier1,/turf/open/floor/plating/rust,/area/engine/storage)
"dx" = (/obj/structure/fence/corner{dir = 6},/obj/structure/cable,/obj/machinery/porta_turret/syndicate/energy/raven,/turf/open/floor/plating/snowed/icemoon,/area/icemoon/surface/outdoors)
"dJ" = (/obj/structure/rack,/obj/item/mecha_parts/mecha_equipment/hydraulic_clamp,/obj/item/mecha_parts/mecha_equipment/drill/diamonddrill,/turf/open/floor/plating/rust,/area/engine/storage)
"fj" = (/obj/item/mecha_parts/chassis/odysseus,/obj/item/mecha_parts/part/odysseus_head,/obj/item/mecha_parts/part/odysseus_left_arm,/obj/item/mecha_parts/part/odysseus_left_leg,/obj/item/mecha_parts/part/odysseus_right_arm,/obj/item/mecha_parts/part/odysseus_right_leg,/obj/item/mecha_parts/part/odysseus_torso,/obj/structure/rack,/obj/item/mecha_parts/mecha_equipment/medical/mechmedbeam,/obj/item/mecha_parts/mecha_equipment/medical/sleeper,/obj/item/mecha_parts/mecha_equipment/medical/syringe_gun,/turf/open/floor/plating/rust,/area/engine/storage)
"fz" = (/obj/structure/cable,/obj/structure/fence/door,/turf/open/floor/plating/snowed/icemoon,/area/icemoon/surface/outdoors)
"fD" = (/obj/structure/closet/emcloset,/obj/effect/decal/fakelattice,/turf/open/floor/plating/rust,/area/engine/storage)
"fT" = (/obj/effect/decal/cleanable/plasma,/obj/effect/decal/cleanable/dirt,/turf/open/floor/plating/rust,/area/engine/storage)
"hI" = (/obj/effect/decal/remains/robot,/turf/open/floor/plating/rust,/area/engine/storage)
"hY" = (/obj/effect/decal/cleanable/wrapping,/obj/effect/decal/cleanable/plasma,/obj/effect/decal/cleanable/blood/old,/turf/open/floor/plating/rust,/area/engine/storage)
"if" = (/obj/structure/cable,/obj/effect/decal/cleanable/plasma,/obj/effect/decal/cleanable/greenglow,/obj/effect/decal/cleanable/dirt,/turf/open/floor/plating,/area/engine/storage)
"ja" = (/obj/structure/table/reinforced,/obj/effect/decal/cleanable/dirt,/obj/effect/decal/fakelattice,/obj/item/clothing/under/misc/durathread/kepler,/obj/item/clothing/head/welding,/obj/item/soap/deluxe,/turf/open/floor/plating/rust,/area/engine/storage)
"jD" = (/obj/structure/fence/corner{dir = 6},/turf/open/floor/plating/asteroid/snow/icemoon,/area/icemoon/surface/outdoors)
"lb" = (/obj/effect/turf_decal/weather/snow/corner{dir = 4},/turf/closed/wall/r_wall,/area/engine/storage)
"md" = (/obj/effect/turf_decal/weather/snow/corner{dir = 8},/turf/closed/wall/r_wall/rust,/area/engine/storage)
"mx" = (/turf/closed/mineral/snowmountain,/area/icemoon/surface/outdoors)
"mV" = (/obj/effect/decal/remains/human,/obj/item/clothing/under/rank/rnd/roboticist,/turf/open/floor/plating/rust,/area/engine/storage)
"nc" = (/obj/structure/mecha_wreckage/marauder,/obj/effect/decal/fakelattice,/turf/open/floor/plating/rust,/area/engine/storage)
"nk" = (/obj/effect/decal/cleanable/robot_debris/old,/obj/effect/decal/cleanable/blood/old,/turf/open/floor/plating,/area/engine/storage)
"np" = (/obj/effect/decal/cleanable/plasma,/obj/effect/decal/cleanable/oil/slippery,/obj/machinery/light/floor,/turf/open/floor/plating,/area/engine/storage)
"ns" = (/obj/structure/cable,/obj/effect/decal/cleanable/dirt,/obj/machinery/power/apc/auto_name/east,/obj/machinery/power/rtg,/turf/open/floor/plating/rust,/area/engine/storage)
"oe" = (/obj/structure/cable,/obj/effect/decal/cleanable/dirt,/obj/machinery/mech_bay_recharge_port,/turf/open/floor/plating,/area/engine/storage)
"ot" = (/obj/vehicle/sealed/mecha/working/ripley/mk2{internals_req_access = list(1); max_equip = 8},/turf/open/floor/mech_bay_recharge_floor,/area/engine/storage)
"ox" = (/obj/effect/decal/cleanable/plasma,/obj/effect/decal/cleanable/oil/slippery,/obj/effect/decal/cleanable/dirt,/obj/machinery/computer/mech_bay_power_console,/obj/item/weldingtool/hugetank,/turf/open/floor/plating,/area/engine/storage)
"pf" = (/obj/structure/chair/plastic{dir = 4},/turf/open/floor/plating,/area/engine/storage)
"pI" = (/obj/structure/table/reinforced,/obj/effect/decal/fakelattice,/obj/machinery/cell_charger,/obj/item/stock_parts/cell/high/plus,/turf/open/floor/plating/rust,/area/engine/storage)
"qm" = (/obj/effect/turf_decal/weather/snow/corner{dir = 4},/turf/closed/wall/r_wall/rust,/area/engine/storage)
"qM" = (/obj/structure/closet/firecloset,/obj/effect/decal/fakelattice,/turf/open/floor/plating,/area/engine/storage)
"sL" = (/obj/structure/cable,/obj/effect/decal/cleanable/blood/old,/turf/open/floor/plating,/area/engine/storage)
"tj" = (/obj/structure/cable,/obj/effect/decal/cleanable/dirt,/obj/structure/closet/crate/secure/plasma,/obj/item/stack/sheet/mineral/plasma/thirty,/turf/open/floor/plating,/area/engine/storage)
"tn" = (/obj/structure/cable,/turf/open/floor/plating,/area/engine/storage)
"tH" = (/obj/structure/fence{dir = 8},/turf/open/floor/plating/snowed/icemoon,/area/icemoon/surface/outdoors)
"ug" = (/obj/structure/cable,/turf/open/floor/plating/rust,/area/engine/storage)
"uZ" = (/obj/structure/cable,/obj/effect/decal/cleanable/robot_debris,/turf/open/floor/plating/rust,/area/engine/storage)
"vp" = (/obj/structure/table/reinforced,/obj/effect/decal/cleanable/dirt,/obj/effect/decal/fakelattice,/obj/item/storage/toolbox/mechanical,/obj/item/gun/ballistic/automatic/sniper_rifle/solgov,/turf/open/floor/plating/rust,/area/engine/storage)
"yU" = (/obj/effect/decal/cleanable/plasma,/obj/effect/decal/cleanable/dirt,/obj/effect/decal/fakelattice,/obj/structure/mecha_wreckage/durand,/turf/open/floor/plating/rust,/area/engine/storage)
"yZ" = (/obj/effect/decal/cleanable/oil/slippery,/turf/open/floor/plating,/area/engine/storage)
"zk" = (/obj/effect/decal/cleanable/dirt,/obj/effect/mob_spawn/human/corpse/solgovcorpsepilot,/turf/open/floor/plating,/area/engine/storage)
"zt" = (/obj/structure/fence{dir = 8},/obj/structure/cable,/turf/open/floor/plating/snowed/icemoon,/area/icemoon/surface/outdoors)
"zL" = (/obj/effect/decal/remains/human,/turf/closed/mineral/snowmountain,/area/icemoon/surface/outdoors)
"zW" = (/obj/effect/turf_decal/weather/snow/corner{dir = 10},/obj/machinery/porta_turret/syndicate/energy/raven,/turf/closed/wall/r_wall,/area/engine/storage)
"AN" = (/obj/effect/turf_decal/weather/snow/corner,/turf/closed/wall/r_wall/rust,/area/engine/storage)
"Bc" = (/obj/effect/decal/cleanable/plasma,/obj/item/paper/crumpled/bloody{desc = "A bloody piece of paper with something written on it..."; info = "Spent all night trying to fix this thing, hopes you're proud of me commander!"; name = "Bloody paper"},/turf/open/floor/plating/rust,/area/engine/storage)
"Bn" = (/obj/effect/turf_decal/weather/snow/corner{dir = 9},/obj/machinery/porta_turret/syndicate/energy/raven,/turf/closed/wall/r_wall/rust,/area/engine/storage)
"Di" = (/obj/machinery/button{id = "RuinsMechHangar"},/obj/structure/cable,/obj/effect/turf_decal/weather/snow/corner,/turf/closed/indestructible/reinforced,/area/engine/storage)
"DB" = (/obj/machinery/door/airlock/hatch{name = "Cold Storage"},/obj/structure/fans/tiny,/turf/open/floor/plating,/area/engine/storage)
"EZ" = (/obj/effect/decal/fakelattice,/turf/closed/wall/r_wall,/area/engine/storage)
"Ft" = (/obj/structure/cable,/obj/machinery/power/rtg,/turf/open/floor/plating/rust,/area/engine/storage)
"Fx" = (/obj/machinery/door/poddoor/shutters{id = "RuinsMechHangar"; max_integrity = 600; name = "Garage"},/obj/structure/fans/tiny,/turf/open/floor/plating,/area/engine/storage)
"GG" = (/obj/effect/turf_decal/weather/snow/corner{dir = 1},/turf/closed/wall/r_wall,/area/engine/storage)
"Hj" = (/obj/effect/turf_decal/weather/snow/corner{dir = 5},/obj/machinery/porta_turret/syndicate/energy/raven,/turf/closed/indestructible/reinforced,/area/engine/storage)
"HO" = (/obj/machinery/door/poddoor/shutters{id = "SolGovMechHangar"; max_integrity = 600; name = "Garage"},/obj/structure/fans/tiny,/turf/open/floor/plating,/area/engine/storage)
"IG" = (/obj/effect/turf_decal/weather/snow/corner,/turf/closed/wall/r_wall,/area/engine/storage)
"JU" = (/obj/structure/mecha_wreckage/odysseus,/turf/open/floor/plating,/area/engine/storage)
"Kv" = (/obj/effect/turf_decal/weather/snow/corner{dir = 6},/obj/machinery/porta_turret/syndicate/energy/raven,/turf/closed/wall/r_wall/rust,/area/engine/storage)
"Kx" = (/obj/structure/fence,/turf/open/floor/plating/asteroid/snow/icemoon,/area/icemoon/surface/outdoors)
"Me" = (/obj/structure/flora/tree/pine,/turf/open/floor/plating/asteroid/snow/icemoon,/area/icemoon/surface/outdoors)
"Nz" = (/turf/open/floor/plating/asteroid/snow/icemoon,/area/icemoon/surface/outdoors)
"NI" = (/obj/effect/mine/explosive,/turf/open/floor/plating/snowed/icemoon,/area/icemoon/surface/outdoors)
"Pe" = (/obj/structure/cable,/turf/open/floor/plating/snowed/icemoon,/area/icemoon/surface/outdoors)
"QK" = (/turf/open/floor/plating/snowed/icemoon,/area/icemoon/surface/outdoors)
"QU" = (/obj/machinery/mech_bay_recharge_port,/obj/structure/cable,/turf/open/floor/plating/rust,/area/engine/storage)
"Ry" = (/obj/structure/closet/crate/grave,/obj/item/nullrod/claymore{block_chance = 60; desc = "A weapon fit for a crusader, 'VOC' is carved onto the side"; force = 20},/turf/open/floor/plating/asteroid/snow/icemoon,/area/icemoon/surface/outdoors)
"Tg" = (/obj/effect/mine/explosive,/turf/open/floor/plating/asteroid/snow/icemoon,/area/icemoon/surface/outdoors)
"Vx" = (/obj/structure/cable,/obj/machinery/power/floodlight{anchored = 1},/turf/open/floor/plating/snowed/icemoon,/area/icemoon/surface/outdoors)
"VA" = (/obj/structure/mecha_wreckage/gygax,/turf/open/floor/mech_bay_recharge_floor,/area/engine/storage)
"VP" = (/obj/machinery/computer/mech_bay_power_console,/obj/structure/cable,/turf/open/floor/plating/rust,/area/engine/storage)
"VT" = (/obj/effect/decal/cleanable/dirt,/obj/structure/closet/secure_closet/engineering_welding,/turf/open/floor/plating/rust,/area/engine/storage)
"Wc" = (/obj/effect/turf_decal/weather/snow/corner{dir = 1},/turf/closed/wall/r_wall/rust,/area/engine/storage)
"Xl" = (/obj/structure/reagent_dispensers/fueltank,/obj/effect/decal/cleanable/dirt,/turf/open/floor/plating/rust,/area/engine/storage)
"XD" = (/obj/effect/turf_decal/weather/snow/corner{dir = 1},/turf/closed/indestructible/reinforced,/area/engine/storage)
"XE" = (/obj/structure/fence/corner{dir = 1},/turf/open/floor/plating/asteroid/snow/icemoon,/area/icemoon/surface/outdoors)
"XV" = (/obj/structure/reagent_dispensers/fueltank,/obj/effect/decal/cleanable/cobweb/cobweb2,/obj/effect/decal/cleanable/plasma,/obj/effect/decal/fakelattice,/turf/open/floor/plating/rust,/area/engine/storage)
"Yl" = (/obj/effect/turf_decal/weather/snow/corner{dir = 4},/turf/closed/indestructible/reinforced,/area/engine/storage)
"Zb" = (/obj/structure/fence{dir = 8},/turf/open/floor/plating/asteroid/snow/icemoon,/area/icemoon/surface/outdoors)
"Zg" = (/obj/structure/cable,/obj/effect/decal/cleanable/dirt,/turf/open/floor/plating,/area/engine/storage)

(1,1,1) = {"
mxmxmxmxmxmxmxmxmxmxmxmxmxmxmx
mxmxmxmxmxmxmxmxmxmxmxmxmxmxmx
mxmxBnGGGGGGXDXDGGWcWcGGHjmxmx
mxmxcjdmdJfjQUVAVPVTXlXVYlmxmx
mxmxcjfDfThIugmVifZghYjalbmxmx
mxmxmdncnknpoeotoxZgpfpIqmmxmx
mxmxcjqMsLtnZgtntntjuZvplbmxmx
mxmxcjyUZgyZJUzkcCBcFtnslbmxmx
mxzLzWANDiDBEZFxHOFxIGANKvmxmx
KxMeNzNIPeQKQKQKQKQKRyNzNzNzKx
KxmxmxmxPeNzQKQKQKNzNzNzTgNzKx
KxmxmxNzVxQKQKMeNzNzNzNzNzNzKx
XEZbZbtHztfzdxtHZbZbZbZbZbZbjD
NzNzNzNzNzNzNzNzNzNzNzNzNzNzNz
NzNzNzNzNzNzTgNzNzNzNzNzNzMeNz
"}
