"cj" = (/obj/structure/mecha_wreckage/gygax,/turf/open/floor/mech_bay_recharge_floor,/area/engine/storage)
"dm" = (/obj/structure/closet/firecloset,/obj/effect/decal/fakelattice,/turf/open/floor/plating,/area/engine/storage)
"dJ" = (/obj/structure/chair/plastic{dir = 4},/turf/open/floor/plating,/area/engine/storage)
"dM" = (/obj/structure/cable,/obj/effect/decal/cleanable/dirt,/obj/structure/closet/crate/secure/plasma,/obj/item/stack/sheet/mineral/plasma/thirty,/turf/open/floor/plating,/area/engine/storage)
"dO" = (/obj/structure/closet/emcloset,/obj/effect/decal/fakelattice,/turf/open/floor/plating/rust,/area/engine/storage)
"fj" = (/obj/structure/fence/corner{dir = 6},/turf/open/floor/plating/asteroid/snow/icemoon,/area/icemoon/surface/outdoors)
"fD" = (/obj/structure/reagent_dispensers/fueltank,/obj/effect/decal/cleanable/cobweb/cobweb2,/obj/effect/decal/cleanable/plasma,/obj/effect/decal/fakelattice,/turf/open/floor/plating/rust,/area/engine/storage)
"fE" = (/obj/effect/decal/remains/human,/obj/item/clothing/under/rank/rnd/roboticist,/turf/open/floor/plating/rust,/area/engine/storage)
"fH" = (/obj/effect/decal/cleanable/wrapping,/obj/effect/decal/cleanable/plasma,/obj/effect/decal/cleanable/blood/old,/turf/open/floor/plating/rust,/area/engine/storage)
"fT" = (/obj/structure/mecha_wreckage/odysseus,/turf/open/floor/plating,/area/engine/storage)
"gw" = (/obj/effect/decal/cleanable/plasma,/obj/item/paper/crumpled/bloody{desc = "A bloody piece of paper with something written on it..."; info = "Spent all night trying to fix this thing, hopes you're proud of me commander!"; name = "Bloody paper"},/turf/open/floor/plating/rust,/area/engine/storage)
"hI" = (/obj/effect/decal/cleanable/plasma,/obj/effect/decal/cleanable/oil/slippery,/obj/effect/decal/cleanable/dirt,/obj/machinery/computer/mech_bay_power_console,/obj/item/weldingtool/hugetank,/turf/open/floor/plating,/area/engine/storage)
"hY" = (/obj/structure/closet/crate/grave,/obj/item/nullrod/claymore{block_chance = 60; desc = "A weapon fit for a crusader, 'VOC' is carved onto the side"; force = 20},/turf/open/floor/plating/asteroid/snow/icemoon,/area/icemoon/surface/outdoors)
"if" = (/turf/open/floor/plating/snowed/icemoon,/area/icemoon/surface/outdoors)
"ja" = (/obj/effect/turf_decal/weather/snow/corner{dir = 1},/turf/closed/indestructible/reinforced,/area/engine/storage)
"lb" = (/obj/item/mecha_parts/chassis/odysseus,/obj/item/mecha_parts/part/odysseus_head,/obj/item/mecha_parts/part/odysseus_left_arm,/obj/item/mecha_parts/part/odysseus_left_leg,/obj/item/mecha_parts/part/odysseus_right_arm,/obj/item/mecha_parts/part/odysseus_right_leg,/obj/item/mecha_parts/part/odysseus_torso,/obj/structure/rack,/obj/item/mecha_parts/mecha_equipment/medical/mechmedbeam,/obj/item/mecha_parts/mecha_equipment/medical/sleeper,/obj/item/mecha_parts/mecha_equipment/medical/syringe_gun,/turf/open/floor/plating/rust,/area/engine/storage)
"lM" = (/obj/effect/decal/cleanable/plasma,/obj/effect/decal/cleanable/dirt,/turf/open/floor/plating/rust,/area/engine/storage)
"md" = (/obj/machinery/button{id = "SolGovMechHangar"},/obj/structure/cable,/obj/effect/turf_decal/weather/snow/corner,/turf/closed/indestructible/reinforced,/area/engine/storage)
"mx" = (/turf/closed/mineral/snowmountain,/area/icemoon/surface/outdoors)
"mV" = (/turf/open/floor/plating/asteroid/snow/icemoon,/area/icemoon/surface/outdoors)
"nc" = (/obj/vehicle/sealed/mecha/working/ripley/mk2{internals_req_access = list(1); max_equip = 8},/turf/open/floor/mech_bay_recharge_floor,/area/engine/storage)
"nk" = (/obj/structure/mecha_wreckage/marauder,/obj/effect/decal/fakelattice,/turf/open/floor/plating/rust,/area/engine/storage)
"np" = (/obj/effect/turf_decal/weather/snow/corner{dir = 4},/turf/closed/wall/r_wall,/area/engine/storage)
"oe" = (/obj/effect/turf_decal/weather/snow/corner{dir = 4},/turf/closed/wall/r_wall/rust,/area/engine/storage)
"ot" = (/obj/structure/table/reinforced,/obj/effect/decal/cleanable/dirt,/obj/effect/decal/fakelattice,/obj/item/storage/toolbox/mechanical,/obj/item/gun/ballistic/automatic/sniper_rifle/solgov,/turf/open/floor/plating/rust,/area/engine/storage)
"ox" = (/obj/effect/turf_decal/weather/snow/corner,/turf/closed/wall/r_wall,/area/engine/storage)
"pf" = (/obj/effect/decal/cleanable/dirt,/obj/effect/mob_spawn/human/corpse/solgovcorpsepilot,/turf/open/floor/plating,/area/engine/storage)
"pA" = (/obj/machinery/door/poddoor/shutters{id = "SolGovMechHangar"; max_integrity = 600; name = "Garage"},/obj/structure/fans/tiny,/turf/open/floor/plating,/area/engine/storage)
"pI" = (/obj/effect/decal/cleanable/dirt,/obj/effect/decal/cleanable/blood/old,/turf/open/floor/plating,/area/engine/storage)
"qm" = (/obj/effect/turf_decal/weather/snow/corner{dir = 8},/turf/closed/wall/r_wall/rust,/area/engine/storage)
"qM" = (/obj/structure/flora/tree/pine,/turf/open/floor/plating/asteroid/snow/icemoon,/area/icemoon/surface/outdoors)
"tn" = (/obj/structure/cable,/obj/effect/decal/cleanable/dirt,/obj/machinery/power/apc/auto_name/east,/obj/machinery/power/rtg,/turf/open/floor/plating/rust,/area/engine/storage)
"uZ" = (/obj/structure/cable,/obj/machinery/power/rtg,/turf/open/floor/plating/rust,/area/engine/storage)
"vm" = (/obj/effect/decal/remains/robot,/turf/open/floor/plating/rust,/area/engine/storage)
"vp" = (/obj/effect/turf_decal/weather/snow/corner{dir = 1},/turf/closed/wall/r_wall,/area/engine/storage)
"yU" = (/obj/structure/reagent_dispensers/fueltank,/obj/effect/decal/cleanable/dirt,/turf/open/floor/plating/rust,/area/engine/storage)
"zk" = (/obj/structure/table/reinforced,/obj/effect/decal/fakelattice,/obj/machinery/cell_charger,/obj/item/stock_parts/cell/high/plus,/turf/open/floor/plating/rust,/area/engine/storage)
"zL" = (/obj/effect/decal/cleanable/robot_debris/old,/obj/effect/decal/cleanable/blood/old,/turf/open/floor/plating,/area/engine/storage)
"zW" = (/obj/structure/cable,/obj/effect/decal/cleanable/blood/old,/turf/open/floor/plating,/area/engine/storage)
"AN" = (/obj/structure/fence{dir = 8},/turf/open/floor/plating/asteroid/snow/icemoon,/area/icemoon/surface/outdoors)
"Bn" = (/turf/open/space/basic,/area/space)
"CJ" = (/obj/structure/cable,/turf/open/floor/plating/snowed/icemoon,/area/icemoon/surface/outdoors)
"Di" = (/obj/effect/decal/cleanable/plasma,/obj/effect/decal/cleanable/dirt,/obj/effect/decal/fakelattice,/obj/structure/mecha_wreckage/durand,/turf/open/floor/plating/rust,/area/engine/storage)
"DB" = (/obj/structure/rack,/obj/item/mecha_parts/mecha_equipment/weapon/energy/plasma,/obj/effect/decal/cleanable/cobweb,/obj/effect/decal/cleanable/dirt,/obj/effect/decal/fakelattice,/obj/item/mecha_parts/mecha_equipment/weapon/energy/laser/heavy,/obj/effect/spawner/lootdrop/tierweapon/ranged/tier1,/obj/effect/spawner/lootdrop/tierweapon/ranged/tier1,/turf/open/floor/plating/rust,/area/engine/storage)
"Eu" = (/obj/machinery/mech_bay_recharge_port,/obj/structure/cable,/turf/open/floor/plating/rust,/area/engine/storage)
"EZ" = (/obj/structure/cable,/obj/effect/decal/cleanable/robot_debris,/turf/open/floor/plating/rust,/area/engine/storage)
"Fx" = (/obj/effect/decal/cleanable/plasma,/obj/effect/decal/cleanable/oil/slippery,/obj/machinery/light/floor,/turf/open/floor/plating,/area/engine/storage)
"FU" = (/obj/structure/cable,/obj/structure/fence/door,/turf/open/floor/plating/snowed/icemoon,/area/icemoon/surface/outdoors)
"GG" = (/obj/effect/turf_decal/weather/snow/corner{dir = 5},/obj/machinery/porta_turret/syndicate/energy/raven,/turf/closed/indestructible/reinforced,/area/engine/storage)
"Hj" = (/obj/effect/decal/cleanable/dirt,/obj/structure/closet/secure_closet/engineering_welding,/turf/open/floor/plating/rust,/area/engine/storage)
"HO" = (/obj/effect/turf_decal/weather/snow/corner{dir = 1},/turf/closed/wall/r_wall/rust,/area/engine/storage)
"IG" = (/obj/effect/turf_decal/weather/snow/corner{dir = 10},/obj/machinery/porta_turret/syndicate/energy/raven,/turf/closed/wall/r_wall,/area/engine/storage)
"Jv" = (/obj/structure/cable,/obj/machinery/power/floodlight{anchored = 1},/turf/open/floor/plating/snowed/icemoon,/area/icemoon/surface/outdoors)
"Kx" = (/obj/effect/decal/cleanable/oil/slippery,/turf/open/floor/plating,/area/engine/storage)
"Me" = (/obj/structure/cable,/obj/effect/decal/cleanable/dirt,/obj/machinery/mech_bay_recharge_port,/turf/open/floor/plating,/area/engine/storage)
"Nz" = (/obj/effect/turf_decal/weather/snow/corner{dir = 4},/turf/closed/indestructible/reinforced,/area/engine/storage)
"NI" = (/obj/structure/fence,/turf/open/floor/plating/asteroid/snow/icemoon,/area/icemoon/surface/outdoors)
"Pe" = (/obj/structure/cable,/obj/effect/decal/cleanable/dirt,/turf/open/floor/plating,/area/engine/storage)
"QK" = (/obj/machinery/door/airlock/hatch{name = "Cold Storage"},/obj/structure/fans/tiny,/turf/open/floor/plating,/area/engine/storage)
"QU" = (/obj/effect/turf_decal/weather/snow/corner{dir = 6},/obj/machinery/porta_turret/syndicate/energy/raven,/turf/closed/wall/r_wall/rust,/area/engine/storage)
"Rx" = (/obj/structure/cable,/obj/effect/decal/cleanable/plasma,/obj/effect/decal/cleanable/greenglow,/obj/effect/decal/cleanable/dirt,/turf/open/floor/plating,/area/engine/storage)
"Ry" = (/obj/structure/cable,/turf/open/floor/plating/rust,/area/engine/storage)
"Tg" = (/obj/structure/table/reinforced,/obj/effect/decal/cleanable/dirt,/obj/effect/decal/fakelattice,/obj/item/clothing/under/misc/durathread/kepler,/obj/item/clothing/head/welding,/obj/item/soap/deluxe,/turf/open/floor/plating/rust,/area/engine/storage)
"Vx" = (/obj/effect/turf_decal/weather/snow/corner,/turf/closed/wall/r_wall/rust,/area/engine/storage)
"VA" = (/obj/effect/decal/remains/human,/turf/open/floor/plating/asteroid/snow/icemoon,/area/icemoon/surface/outdoors)
"VP" = (/obj/structure/fence/corner{dir = 6},/obj/structure/cable,/obj/machinery/porta_turret/syndicate/energy/raven,/turf/open/floor/plating/snowed/icemoon,/area/icemoon/surface/outdoors)
"VT" = (/obj/structure/fence{dir = 8},/turf/open/floor/plating/snowed/icemoon,/area/icemoon/surface/outdoors)
"Wc" = (/obj/effect/decal/fakelattice,/turf/closed/wall/r_wall,/area/engine/storage)
"Xl" = (/obj/machinery/computer/mech_bay_power_console,/obj/structure/cable,/turf/open/floor/plating/rust,/area/engine/storage)
"XD" = (/obj/effect/turf_decal/weather/snow/corner{dir = 8},/turf/closed/wall/r_wall,/area/engine/storage)
"XV" = (/obj/effect/turf_decal/weather/snow/corner{dir = 9},/obj/machinery/porta_turret/syndicate/energy/raven,/turf/closed/wall/r_wall/rust,/area/engine/storage)
"Yl" = (/obj/structure/rack,/obj/item/mecha_parts/mecha_equipment/hydraulic_clamp,/obj/item/mecha_parts/mecha_equipment/drill/diamonddrill,/turf/open/floor/plating/rust,/area/engine/storage)
"Zb" = (/obj/structure/cable,/turf/open/floor/plating,/area/engine/storage)
"Zg" = (/obj/structure/fence{dir = 8},/obj/structure/cable,/turf/open/floor/plating/snowed/icemoon,/area/icemoon/surface/outdoors)

(1,1,1) = {"
BnBnBnBnBnBnBnBnBnBnBnBnBnBnBnBnBnBnBnBnBnBnBnBnBn
BnBnBnBnBnBnBnBnBnBnBnBnBnBnBnBnBnBnBnBnBnBnBnBnBn
BnBnBnBnBnBnBnBnBnBnBnBnBnBnBnBnBnBnBnBnBnBnBnBnBn
BnBnBnBnBnBnBnBnBnBnBnBnBnBnBnBnBnBnBnBnBnBnBnBnBn
BnBnBnBnBnBnmxmxmxmxmxmxmxmxmxmxmxmxmxBnBnBnBnBnBn
BnBnBnBnBnBnmxXVvpvpvpjajavpHOHOvpGGmxBnBnBnBnBnBn
BnBnBnBnBnBnmxXDDBYllbEucjXlHjyUfDNzmxBnBnBnBnBnBn
BnBnBnBnBnBnmxXDdOlMvmRyfERxPefHTgnpmxBnBnBnBnBnBn
BnBnBnBnBnBnmxqmnkzLFxMenchIPedJzkoemxBnBnBnBnBnBn
BnBnBnBnBnBnmxXDdmzWZbPeZbZbdMEZotnpmxBnBnBnBnBnBn
BnBnBnBnBnBnmxXDDiPeKxfTpfpIgwuZtnnpmxBnBnBnBnBnBn
BnBnBnBnBnBnVAIGVxmdQKWcpApApAoxVxQUmxBnBnBnBnBnBn
BnBnBnBnBnBnqMmVifCJifififififhYmVmVNIBnBnBnBnBnBn
BnBnBnBnBnBnmxmxmxCJmVifififmVmVmVmVNIBnBnBnBnBnBn
BnBnBnBnBnBnmxmxmVJvififqMmVmVmVmVmVNIBnBnBnBnBnBn
BnBnBnBnBnBnANANVTZgFUVPVTANANANANANfjBnBnBnBnBnBn
BnBnBnBnBnBnBnBnBnBnBnBnBnBnBnBnBnBnBnBnBnBnBnBnBn
BnBnBnBnBnBnBnBnBnBnBnBnBnBnBnBnBnBnBnBnBnBnBnBnBn
BnBnBnBnBnBnBnBnBnBnBnBnBnBnBnBnBnBnBnBnBnBnBnBnBn
BnBnBnBnBnBnBnBnBnBnBnBnBnBnBnBnBnBnBnBnBnBnBnBnBn
BnBnBnBnBnBnBnBnBnBnBnBnBnBnBnBnBnBnBnBnBnBnBnBnBn
BnBnBnBnBnBnBnBnBnBnBnBnBnBnBnBnBnBnBnBnBnBnBnBnBn
BnBnBnBnBnBnBnBnBnBnBnBnBnBnBnBnBnBnBnBnBnBnBnBnBn
BnBnBnBnBnBnBnBnBnBnBnBnBnBnBnBnBnBnBnBnBnBnBnBnBn
BnBnBnBnBnBnBnBnBnBnBnBnBnBnBnBnBnBnBnBnBnBnBnBnBn
"}
